"lang"
{
"Language"	"turkish"
"Tokens"
{
"Intro_Start"	"Başlat"
"[english]Intro_Start"	"Start"
"Intro_PlayIntro"	"Girişi Oynat"
"[english]Intro_PlayIntro"	"Play Intro"
"Whiteboard_Title"	"Açık Deneyler"
"[english]Whiteboard_Title"	"Open Experiments"
"Whiteboard_Name"	"İsim"
"[english]Whiteboard_Name"	"Name"
"Whiteboard_Complete"	"Tamamlandı?"
"[english]Whiteboard_Complete"	"Complete?"
"Clip_Experiment"	"Deney"
"[english]Clip_Experiment"	"Experiment"
"Clip_Description"	"Açıklama"
"[english]Clip_Description"	"Description"
"Clip_Comments"	"Yorumlar"
"[english]Clip_Comments"	"Comments"
"Clip_Postcards_Title"	"Kartpostallar"
"[english]Clip_Postcards_Title"	"Postcards"
"Clip_Postcards_Text"	"Her kartpostal dünyanın dört bir yanından farklı bir konuma erişir."
"[english]Clip_Postcards_Text"	"Each postcard traverses to a different location from around the world."
"Clip_Postcards_Comm"	"- Gönderileceğiniz konumu seçmek için fişi hareket ettirin."
"[english]Clip_Postcards_Comm"	"- Move the plug to select which location you will be sent to."
"Clip_Slingshot_Title"	"Sapan"
"[english]Clip_Slingshot_Title"	"Slingshot"
"Clip_Slingshot_Text"	"Bir Aperture Science Depolama İlavesini yıkıcı bir şekilde yok etmek için kullanılabilecek bir Çekirdek Ölçümleme sapanına gönderir."
"[english]Clip_Slingshot_Text"	"Outputs to a Core Calibration slingshot, which can be used to recklessly destroy an Aperture Science Storage Annex."
"Clip_Longbow_Title"	"Yay"
"[english]Clip_Longbow_Title"	"Longbow"
"Clip_Longbow_Text"	"Okçuluk yeteneklerinin kudurmuş bir orduya karşı savunmak zorunda olduğu saldırı altındaki bir kaleye bağlanıyor."
"[english]Clip_Longbow_Text"	"Connects to a castle under siege, where archery skills must defend against a rampaging horde."
"Clip_Longbow_Comm"	"- Bekle, bu bir olimpik yay değil mi?\n- Kapa çeneni Daryl."
"[english]Clip_Longbow_Comm"	"- Wait, isn't that a recurve bow?\n- Shut up, Daryl."
"Clip_Xortex_Title"	"Xortex 26XX"
"[english]Clip_Xortex_Title"	"Xortex 26XX"
"Clip_Xortex_Text"	"Saldırganlara saldırırken düşman ateşi yağmurundan kaçabilen bir drone savaşçısına gönderir."
"[english]Clip_Xortex_Text"	"Uplinks to a drone fighter capable of maneuvering through a hail of enemy fire as it shoots down attackers."
"Clip_Xortex_Comm"	"- Piyuv piyuv piyuv!"
"[english]Clip_Xortex_Comm"	"- Pew pew pew!"
"Clip_Planets_Title"	"Güneş Sistemi"
"[english]Clip_Planets_Title"	"Solar System"
"Clip_Planets_Text"	"Heykel, güneş sistemini içindeki gezegenleri doğru ölçekli halleri ile gösteren bir portre gösterir."
"[english]Clip_Planets_Text"	"Relic emits a portrayal of the solar system with all planets in their correct relative scale."
"Clip_Planets_Comm"	"- Ve göreceli yörünge mesafeleri? \n- Muhtelemen bu kadar yürümek istemiyorsundur."
"[english]Clip_Planets_Comm"	"- And relative orbital distances?\n- You probably don't want to walk that far."
"Clip_HumanBody_Title"	"İnsan Vücudu Taraması"
"[english]Clip_HumanBody_Title"	"Human Body Scan"
"Clip_HumanBody_Text"	"İnsan türünün keşfedilebilir üç boyutlu bir modeline götürüyor gibi gözüküyor."
"[english]Clip_HumanBody_Text"	"Seems to lead to an explorable three dimensional model of the human form."
"Clip_HumanBody_Comm"	"- Üç boyutlu cesetler mi? İmkansız!"
"[english]Clip_HumanBody_Comm"	"- Three dimensional bodies? Impossible!"
"Clip_RobotRepair_Title"	"Robot Tamiri"
"[english]Clip_RobotRepair_Title"	"Robot Repair"
"Clip_RobotRepair_Text"	"Hasarlı bir AT-D7796 robotunun yardıma ihtiyaç duyduğu Aperture Science'a gönderir."
"[english]Clip_RobotRepair_Text"	"Traverses to Aperture Science, where a damaged AT-D7796 robot requires assistance."
"Clip_RobotRepair_Comm"	"- Sonuçta Laboratuvar 44'e olan şey buydu."
"[english]Clip_RobotRepair_Comm"	"- So that's what happened to Lab 44."
"Clip_SecretShop_Title"	"Gizli Dükkân"
"[english]Clip_SecretShop_Title"	"Secret Shop"
"Clip_SecretShop_Text"	"Antik bir şeylerin savunmasında sıkça kullanıldığını düşündüğümüz, büyülü eserlerle ile dolu olan bir dükkâna çıkıyor."
"[english]Clip_SecretShop_Text"	"Leads to a storehouse filled with magical artifacts we believe are most commonly used to defend ancients."
"Clip_SecretShop_Comm"	"- Şşt!"
"[english]Clip_SecretShop_Comm"	"- Shh!"
"Clip_DemoRoom1_Title"	"Valve Demo Odası"
"[english]Clip_DemoRoom1_Title"	"Valve Demo Room"
"Clip_DemoRoom1_Text"	"Valve'ın geliştirmekte olduğu oda ölçekli VR'ın ilk deneyleri için Valve HQ'daki bu oda kullanıldı.\n\nBaşlığa yerleştirilen bir kamera duvardaki kodları tanıyarak kullanan kişinin konumunu takip etmektedir. Prototip ekranlar iki cep telefonun özel devrelerle bağlanmasıyla yapıldı."
"[english]Clip_DemoRoom1_Text"	"Valve's early experiments in developing room-scale VR took place in this room at Valve HQ.\n\nA camera mounted on the headset recognizes codes on the walls to track the wearer's position. The prototype displays were built from two cellphones connected with custom circuitry."
"Clip_DemoRoom2_Title"	"Valve Demo Odası"
"[english]Clip_DemoRoom2_Title"	"Valve Demo Room"
"Clip_DemoRoom2_Text"	"Oda ölçeği VR lazer izleme teknolojisi kod adı Lighthouse ile geliştirildi. Her ana istasyon başlığı kullanan kişiyi çok hassas bir şekilde takip edebilmesi için kızılötesi lazer yaymaktadır.\n\nBu demodaki Valve HQ, birbirinden farklı yüzlerce VR tecrübesinin gösterilmesi için kullanıldı."
"[english]Clip_DemoRoom2_Text"	"Room-scale VR evolved with the invention of laser tracking technology, codenamed Lighthouse. Each base station emits infrared lasers which sweep across the headset, allowing precise tracking of the wearer's position.\n\nThis demo room in Valve HQ was used to showcase hundreds of different VR experiments."
"Slingshot_Leaderboard"	"Küresel Sıralama Listesi"
"[english]Slingshot_Leaderboard"	"Global Leaderboard"
"Slingshot_Rank"	"Rütbe"
"[english]Slingshot_Rank"	"Rank"
"Slingshot_Name"	"İsim"
"[english]Slingshot_Name"	"Name"
"Slingshot_Score"	"Puan"
"[english]Slingshot_Score"	"Score"
"Slingshot_Damage"	"HASAR..."
"[english]Slingshot_Damage"	"DAMAGE..."
"Slingshot_Previous"	"Önceki Atış"
"[english]Slingshot_Previous"	"Previous Shot"
"Xortex_PickUpDrone"	"OYUNA BAŞLAMAK İÇİN\nGEMİYİ ALIN"
"[english]Xortex_PickUpDrone"	"PICK UP SHIP\nTO START GAME"
"Xortex_PullTrigger"	"OYUNA BAŞLAMAK İÇİN\nTETİĞİ ÇEKİN"
"[english]Xortex_PullTrigger"	"PULL TRIGGER\nTO START GAME"
"Xortex_Victory"	"ZAFER!"
"[english]Xortex_Victory"	"VICTORY!"
"Xortex_GameOver"	"OYUN BİTTİ"
"[english]Xortex_GameOver"	"GAME OVER"
"Xortex_Leaderboards"	"SIRALAMA LİSTELERİ"
"[english]Xortex_Leaderboards"	"LEADERBOARDS"
"Xortex_FriendScores"	"ARKADAŞ PUANLARI"
"[english]Xortex_FriendScores"	"FRIEND SCORES"
"Xortex_GlobalScores"	"KÜRESEL PUANLAR"
"[english]Xortex_GlobalScores"	"GLOBAL SCORES"
"Xortex_Hint_Aim"	"ATEŞ ETMEK İÇİN DÜŞMANI HEDEF ALIN"
"[english]Xortex_Hint_Aim"	"AIM AT ENEMIES TO SHOOT"
"Xortex_Hint_Attacks"	"KIRMIZI SALDIRILAR GEMİNİZİ YOK EDECEKTİR"
"[english]Xortex_Hint_Attacks"	"RED ATTACKS WILL DESTROY YOUR SHIP"
"Xortex_Hint_Orbs"	"LAZERİ ŞARJ ETMEK İÇİN {0} KÜRE TOPLAYIN"
"[english]Xortex_Hint_Orbs"	"COLLECT {0} ORBS TO CHARGE LASER"
"Xortex_Hint_Special"	"LAZERİ AKTİFLEŞTİRMEK İÇİN TETİKLEYİCİYİ ÇEKİN"
"[english]Xortex_Hint_Special"	"PULL TRIGGER TO ACTIVATE LASER"
"VesperPeak_NorthFace"	"Kuzey Yüzü"
"[english]VesperPeak_NorthFace"	"North Face"
"VesperPeak_SouthVista"	"Güney Vista"
"[english]VesperPeak_SouthVista"	"South Vista"
"Longbow_Wave"	"Dalga"
"[english]Longbow_Wave"	"Wave"
"Longbow_Health"	"Kapı Sağlığı"
"[english]Longbow_Health"	"Gate Health"
"Longbow_Win"	"Orduyu mağlup ettin!"
"[english]Longbow_Win"	"You have defeated the horde!"
"Longbow_Lose"	"Ordu kalenizi yağmaladı!"
"[english]Longbow_Lose"	"The horde has sacked your castle!"
"Longbow_Rabble"	"Ordu kalenizi tehdit ediyor!"
"[english]Longbow_Rabble"	"The horde is threatening your castle!"
"Longbow_Instructions"	"Kalenizi savunun!"
"[english]Longbow_Instructions"	"Defend your castle!"
"Longbow_Score"	"Skor"
"[english]Longbow_Score"	"Score"
"Xortex_Hint_Orbs_Laser"	"LAZERİ ŞARJ ETMEK İÇİN {0} KÜRE TOPLAYIN"
"[english]Xortex_Hint_Orbs_Laser"	"COLLECT {0} ORBS TO CHARGE LASER"
"Xortex_Hint_Orbs_Bomb"	"BOMBAYI ŞARJ ETMEK İÇİN {0} KÜRE TOPLAYIN"
"[english]Xortex_Hint_Orbs_Bomb"	"COLLECT {0} ORBS TO CHARGE BOMB"
"Xortex_Hint_Bomb"	"BOMBAYI PATLATMAK İÇİN TETİĞİ ÇEKİN"
"[english]Xortex_Hint_Bomb"	"PULL TRIGGER TO DETONATE BOMB"
"Xortex_Wave"	"DALGA-{0}"
"[english]Xortex_Wave"	"WAVE-{0}"
"Xortex_BestScore"	"EN İYİ: {0}"
"[english]Xortex_BestScore"	"BEST: {0}"
"Xortex_HighScores"	"YÜKSEK SKORLAR"
"[english]Xortex_HighScores"	"HIGH SCORES"
"Xortex_ModeTitle"	"MOD SEÇİN"
"[english]Xortex_ModeTitle"	"SELECT MODE"
"Xortex_ModeText"	"MOD SEÇMEK İÇİN TETİĞİ ÇEKİN"
"[english]Xortex_ModeText"	"PULL TRIGGER TO SELECT MODE"
"Xortex_ClassicTitle"	"KLASİK"
"[english]Xortex_ClassicTitle"	"CLASSIC"
"Xortex_ClassicText"	"XORTEX ÇEKİRDEĞİNİ YENEBİLİR MİSİN?"
"[english]Xortex_ClassicText"	"CAN YOU DEFEAT THE XORTEX CORE?"
"Xortex_InfiniteTitle"	"SONSUZ"
"[english]Xortex_InfiniteTitle"	"INFINITE"
"Xortex_InfiniteText"	"KÜRESEL YÜKSEK SKORA ULAŞ"
"[english]Xortex_InfiniteText"	"ACHIEVE THE GLOBAL HIGH SCORE"
"Intro_SubtitlesOn"	"Altyazılar: Açık"
"[english]Intro_SubtitlesOn"	"Subtitles: ON"
"Intro_SubtitlesOff"	"Altyazılar: Kapalı"
"[english]Intro_SubtitlesOff"	"Subtitles: OFF"
"Xortex_NewBestScore"	"YENİ REKOR!"
"[english]Xortex_NewBestScore"	"NEW RECORD!"
"Title_LevelSelect"	"Seviye Seç"
"[english]Title_LevelSelect"	"Level Select"
"Title_TheLab"	"The Lab"
"[english]Title_TheLab"	"The Lab"
"Title_VesperPeak"	"Vesper Zirvesi"
"[english]Title_VesperPeak"	"Vesper Peak"
"Title_CinderCone"	"Kül Konisi"
"[english]Title_CinderCone"	"Cindercone"
"Title_LavaTube"	"Lav Tüpü"
"[english]Title_LavaTube"	"Lava Tube"
"Title_Venice"	"Venedik"
"[english]Title_Venice"	"Venice"
"Longbow_Win1"	"Düşman yenilgiye uğratıldı! Ama daha fazlası geliyor..."
"[english]Longbow_Win1"	"Horde defeated! But more are coming..."
"Longbow_Win2"	"Bravo! Dinlenmek için biraz bekle!"
"[english]Longbow_Win2"	"Well done! Take a moment to rest!"
"Longbow_Win3"	"Harika savunma! Daha fazlası için hazırlan!"
"[english]Longbow_Win3"	"Excellent defense! Prepare for more!"
"Longbow_Win4"	"Kalabalık yeni bir saldırı için hazırlanıyor!"
"[english]Longbow_Win4"	"The horde is preparing another assault!"
"Longbow_Win5"	"Düşmanın öfkesi büyüyor!"
"[english]Longbow_Win5"	"The horde's fury grows!"
"Longbow_Win6"	"Saldıraları devam ediyor!"
"[english]Longbow_Win6"	"Their onslaught continues!"
"Longbow_Win7"	"Çatışmaya devam, sürü katili!"
"[english]Longbow_Win7"	"Fight on\nhorde slayer!"
"hubannouncer_intro_01"	"Merhaba Test Gezgini ve Aperture Science Alt Evren Arama Merkezi'ne hoş geldin."
"[english]hubannouncer_intro_01"	"Hello, Test Traveler, and welcome to the Aperture Science Sub-Universe Exploration Center."
"hubannouncer_intro_02"	"Lütfen ilerleyin."
"[english]hubannouncer_intro_02"	"Please move forward."
"hubannouncer_intro_move_nag_01"	"İlerlemek için mekansal yeniden atama çubuğunuzu kullanın."
"[english]hubannouncer_intro_move_nag_01"	"Please use your spatial reassignment wand to move forward."
"hubannouncer_intro_move_nag_02"	"İleri yürümek için lütfen değneğini kullan."
"[english]hubannouncer_intro_move_nag_02"	"Please use your wand to move forward."
"hubannouncer_intro_move_nag_03"	"Hala ilerlemediniz. Lütfen ilerleyin."
"[english]hubannouncer_intro_move_nag_03"	"You have not moved forward yet. Please do so now."
"hubannouncer_intro_move_nag_04"	"Bu durumda, her şeyin bulunduğu önünüzdeki alanı \"ileri\" olarak tanımladık."
"[english]hubannouncer_intro_move_nag_04"	"In this instance, we have defined 'forward' as the area directly in front of you where all the things are."
"hubannouncer_intro_move_nag_05"	"Sensörler henüz ilerlemediğinizi belirtiyor."
"[english]hubannouncer_intro_move_nag_05"	"Sensors indicate that you have not moved forward yet."
"hubannouncer_intro_move_nag_06"	"Biyometrik sensörler kalp atış hızında artış, vücutta kızarma, [utanma] ve [şaşkınlık] içeren agresif vücut dili algıladı. Tahmine dayalı analitikler ileriye yürürseniz bu belirtilerin azalacağını gösteriyor."
"[english]hubannouncer_intro_move_nag_06"	"Biometric sensors show increased heart rate, flushed skin and aggressive body language, indicating [embarrassment] and [confusion]. Predictive analytics show moving forward may alleviate these symptoms."
"hubannouncer_intro_03"	"Bu Aperture Science Yüz-Yerleştirmeli Portal Küresi. Bu sizin geniş çaplı keşfedilmemiş dünyalara açılan kapınız."
"[english]hubannouncer_intro_03"	"This is the Aperture Science Face-Mounted Portal Sphere. It is your gateway to a vast continuum of undiscovered worlds."
"hubannouncer_intro_04"	"Tam resmî bildiri: Bu keşfedilmemiş dünyalar spor amaçlı insan avlayan örümcekler, zehirler, asitler ve yırtıcı hayvanlar içerebilir."
"[english]hubannouncer_intro_04"	"Full legal disclosure: These undiscovered worlds may also contain undiscovered spiders, poisons, acids and apex predators that hunt humans for sport."
"hubannouncer_intro_05"	"Portal Küresini yüzünüze koyun."
"[english]hubannouncer_intro_05"	"Put the Portal Sphere on your face now."
"hubannouncer_portal_nag_01"	"Henüz yüzünüze portal küresini yerleştirmediniz. Lütfen şimdi yerleştirin."
"[english]hubannouncer_portal_nag_01"	"You have not put the portal sphere on your face yet. Please do so now."
"hubannouncer_portal_nag_02"	"Portal küresi henüz yüzünüzde değil. Lütfen onu şimdi yüzünüze koyun."
"[english]hubannouncer_portal_nag_02"	"The portal sphere is not on your face yet. Please put it on your face now."
"hubannouncer_portal_nag_03"	"Sensörler portal küresini yüzünüze koymadığınızı gösteriyor."
"[english]hubannouncer_portal_nag_03"	"Sensors indicate that you have not put the portal sphere on your face."
"hubannouncer_portal_nag_04"	"İstediğiniz zaman yüzünüze portal küresini yerleştirmekten çekinmeyin."
"[english]hubannouncer_portal_nag_04"	"Feel free to put the portal sphere on your face at any time immediately."
"hubannouncer_portal_nag_05"	"Portal küresi son 10 saniyedir yüzünüz ile bir etkileşime geçmedi. Bu doğru değil."
"[english]hubannouncer_portal_nag_05"	"The portal sphere has not come into contact with your face in the last ten seconds. This is incorrect."
"hubannouncer_portal_nag_06"	"Sensörler kullanıcı hatasını belirtiyor: Portal küresi yüzünüzde değil."
"[english]hubannouncer_portal_nag_06"	"Sensors indicate user error: The portal sphere is not on your face."
"hubannouncer_portal_nag_07"	"Belirtmek gerekirse, \"yüz\" dediğimiz bölge kafanızın ön kısmıdır. Lütfen şimdi oraya portal küresini yerleştirin."
"[english]hubannouncer_portal_nag_07"	"To clarify: The face part of your body is the section of your head directly in front of you. Please put the portal sphere there now."
"hubannouncer_event_general_01"	"Uyarı, Cep Evren Laboratuvarı Sekiz'in Test Gezgini: Ne yapıyorsun?"
"[english]hubannouncer_event_general_01"	"Attention, Test Traveler in Pocket Universe Lab Eight: What are you doing?"
"hubannouncer_event_general_02"	"Uyarı, Cep Evren Laboratuvarı Sekiz'in Test Gezgini: Lütfen kendinizi tanımlayın."
"[english]hubannouncer_event_general_02"	"Attention, Test Traveler in Pocket Universe Lab Eight: Please explain yourself."
"hubannouncer_event_general_03"	"Uyarı, Cep Evreni Laboratuvarı Sekiz'in Test Gezgini: Devam et."
"[english]hubannouncer_event_general_03"	"Attention, Test Traveler in Pocket Universe Lab Eight: Carry on."
"hubannouncer_event_doorexit_01"	"Bu kapıdan sonrası sadece yük kaldırıcı bölümüdür. Bu noktadan sonra hiçbir yaya trafiğine izin verilmez."
"[english]hubannouncer_event_doorexit_01"	"This door leads to a forklift-only lane. No foot traffic is permitted beyond this point."
"hubannouncer_event_doorexit_02"	"Test laboratuvarının sınırlarını terk etmeyin."
"[english]hubannouncer_event_doorexit_02"	"Do not leave the boundaries of the test lab."
"hubannouncer_event_doorexit_03"	"Test laboratuvarının sınırlarını terk ediyorsunuz. Yapmayın. Teşekkürler."
"[english]hubannouncer_event_doorexit_03"	"You are now leaving the boundaries of the test lab. Don't. Thank you."
"hubannouncer_event_doorexit_04"	"Test laboratuvarının sınırlarını terk etmeyi deniyorsunuz."
"[english]hubannouncer_event_doorexit_04"	"You are attempting to leave the confines of the test lab."
"hubannouncer_event_doorexit_05"	"Arkanızda geniş çaplı keşfedilmemiş dünyalar var. Önünüzde ise bir depo var. Eğer deneyleriniz ataç gerektirecek olursa, size bu kapıyı açmanız için bir anahtar vereceğiz."
"[english]hubannouncer_event_doorexit_05"	"Behind you is a vast continuum of undiscovered worlds. In front of you is a supply closet. If your experiments require paper clips we will give you a key."
"hubannouncer_event_doorexit_rare_01"	"Arındırma Ortağı sizi, deney geçişi sırasında ev sahipliği yapmış olabileceğiniz hastalıklardan, yumurta kümelerinden veya tehlikeli süper parazitlerden arındırana kadar test laboratuvarının sınırlarını terk etmeyin."
"[english]hubannouncer_event_doorexit_rare_01"	"Do not leave the boundaries of the test lab until a Decontamination Associate has cleared you of quarantine from possible diseases, incubating egg clusters or malicious super-parasites you may have become host to during your test-transits."
"hubannouncer_event_throwportal_01"	"Uyarı, Test Gezgini: Portal Kürelerinin üretim maliyeti yedi trilyon dolar. Eğer birini kırarsanız, ücreti ödemenizden düşülecektir."
"[english]hubannouncer_event_throwportal_01"	"Attention, Test Traveler: Portal Spheres cost seven trillion dollars to manufacture. If you break one, it will be deducted from your pay."
"hubannouncer_event_throwportal_02"	"Uyarı, Test Gezgini. Portal Küreleri aynı zamanda çok pahalı olan minyatür patlayıcı kara deliklerdir."
"[english]hubannouncer_event_throwportal_02"	"Attention, Test Traveler. Portal Spheres are highly explosive miniature black holes that are also highly expensive."
"hubannouncer_event_throwportal_03"	"Portal Küreleri minyatür evrenler içeren narin bilimsel aygıtlardır. Ne kadar benzeseler de, basket topu değillerdir."
"[english]hubannouncer_event_throwportal_03"	"Portal spheres are delicate scientific instruments that contain miniature universes. Though they resemble them, they are not basketballs."
"hubannouncer_event_throwportal_04"	"Cep Evren Laboratuvarı Sekiz'de Geçici Deney yeniden atandı."
"[english]hubannouncer_event_throwportal_04"	"Ad hoc Experiment reassignment in Pocket Universe Lab Eight."
"hubannouncer_event_throwportal_05"	"Cep Evren Laboratuvarı Sekiz'de deney taşıma projesi devam ediyor."
"[english]hubannouncer_event_throwportal_05"	"Experiment relocation project underway in Pocket Universe Lab Eight."
"hubannouncer_event_throwportal_06"	"Hatırlatırız: Cep Evren Laboratuvarı Sekiz'deki bir deney geçici olarak başka bir yere taşındı."
"[english]hubannouncer_event_throwportal_06"	"Please be advised: An experiment in Pocket Universe Lab Eight has been temporarily relocated."
"hubannouncer_event_throwclipb_01"	"Cep Evren Laboratuvarı Sekiz'e daha fazla pano gerekiyor."
"[english]hubannouncer_event_throwclipb_01"	"More clipboards required in Pocket Universe Lab Eight."
"hubannouncer_event_throwclipb_02"	"Aperture Science Bilgi Ekranı Tahtaları ilişkili deneyler hakkında veri yaymak için verilmiştir. Onları fırlatmak üzerlerindeki yazıları okumayı zorlaştırır."
"[english]hubannouncer_event_throwclipb_02"	"Aperture Science Information Display Boards have been provided to conveniently exhibit data relevant to their corresponding experiments. Throwing them makes it harder to read them."
"hubannouncer_event_throwclipb_03"	"Aperture Science Bilgi Ekranı Tahtaları aşırı hassas bilgi yayan aygıtlardır. Dokunduğun her şey gibi, ayrıca çok pahalılar."
"[english]hubannouncer_event_throwclipb_03"	"Aperture Science Information Display Boards are highly sensitive information-emitting devices. Like everything else you are touching, they are also very expensive."
"hubannouncer_event_rhythm_01"	"Cep Evren Laboratuvarı Sekiz'de ritim algılandı."
"[english]hubannouncer_event_rhythm_01"	"Rhythms detected in Pocket Universe Lab Eight."
"hubannouncer_event_rhythm_02"	"Cep Evren Laboratuvarı Sekiz'de çok iyi ritim algılandı."
"[english]hubannouncer_event_rhythm_02"	"Very good rhythms detected in Pocket Universe Lab Eight."
"hubannouncer_event_rhythm_03"	"Cep Evreni Laboratuvarı Sekiz'de ritmik çekirdek yeniden konumlandırma devam etmekte."
"[english]hubannouncer_event_rhythm_03"	"Rhythmic core relocation underway in Pocket Universe Lab Eight."
"hubannouncer_event_enter_01"	"Şimdi bir deneye giriliyor."
"[english]hubannouncer_event_enter_01"	"Now entering an experiment."
"hubannouncer_event_enter_02"	"Test aktarımı başlatılıyor... şimdi."
"[english]hubannouncer_event_enter_02"	"Starting test-transit... now."
"hubannouncer_event_enter_03"	"Deney başlatılıyor... şimdi."
"[english]hubannouncer_event_enter_03"	"Starting experiment... now."
"hubannouncer_event_enter_04"	"İyi şanslar."
"[english]hubannouncer_event_enter_04"	"Good luck."
"hubannouncer_event_return_01"	"Tekrar hoş geldiniz."
"[english]hubannouncer_event_return_01"	"Welcome back."
"hubannouncer_event_return_02"	"Tekrar hoş geldin test gezgini."
"[english]hubannouncer_event_return_02"	"Welcome back, test traveler."
"hubannouncer_event_return_03"	"Cep Evren Laboratuvarı Sekiz'in Test Gezgini bir deneyden geri döndü."
"[english]hubannouncer_event_return_03"	"Test Traveler of Pocket Universe Lab Eight has returned from an experiment."
"hubannouncer_event_return_04"	"Cep Evren Laboratuvarı Sekiz'in Test Gezgini bir deneyde başarıyla hayatta kaldı."
"[english]hubannouncer_event_return_04"	"Test Traveler of Pocket Universe Lab Eight has successfully survived an experiment."
"hubannouncer_event_return_05"	"Test Gezgini, Cep Evren Laboratuvarı Sekiz'e başarıyla geri dönmüştür. Tebrikler Test Gezgini."
"[english]hubannouncer_event_return_05"	"Test Traveler has successfully returned in Pocket Universe Lab Eight. Congratulations, Test Traveler."
"hubannouncer_event_return_06"	"Cep Evreni Laboratuvarı Sekiz'in Test Gezgini bir heykel açılımından hayatta kaldı."
"[english]hubannouncer_event_return_06"	"Test Traveler has survived a relic expedition in Pocket Universe Lab Eight."
"hubannouncer_event_return_07"	"Cep Evren Laboratuvarı Sekiz'de deney başarılı bir şekilde tamamlandı."
"[english]hubannouncer_event_return_07"	"Successful completion of experiment in Pocket Universe Lab Eight."
"hubannouncer_event_return_08"	"Cep Evren Laboratuvarı Sekiz bir deneyi sonuçlandırdı. Tebrikler Test Gezgini."
"[english]hubannouncer_event_return_08"	"Pocket Universe Lab Eight has concluded an experiment. Congratulations, Test Traveler."
"hubannouncer_event_return_09"	"Her şeye rağmen Cep Evren Laboratuvarı Sekiz'in Test Gezgini hayatta kaldı."
"[english]hubannouncer_event_return_09"	"Against all odds, Test Traveler of Pocket Universe Lab Eight had survived."
"hubannouncer_event_visitedall_01"	"Cep Evren Laboratuvarı Sekiz'in test gezgini tüm deneyleri başarıyla gerçekleştirdi."
"[english]hubannouncer_event_visitedall_01"	"Test traveler has successfully engaged all experiments in Pocket Universe Lab Eight."
"hubannouncer_event_visitedall_02"	"Test gezgini Cep Evren Laboratuvarı Sekiz'deki tüm deneyleri ziyaret etti."
"[english]hubannouncer_event_visitedall_02"	"Test traveler has visited all experiments in Pocket Universe Lab Eight."
"hubannouncer_event_visitedall_03"	"Test gezgini, Cep Evren Laboratuvarı Sekiz'deki tüm deneyleri keşfetti."
"[english]hubannouncer_event_visitedall_03"	"Test traveler has discovered all experiments in Pocket Universe Lab Eight."
"hubannouncer_event_arcade_01"	"Cep Evreni Laboratuvarı Sekiz'de meta oynama tespit edildi."
"[english]hubannouncer_event_arcade_01"	"Meta gameplay detected in Pocket Universe Lab Eight."
"hubannouncer_event_arcade_02"	"Analiz ediliyor. Dördüncü duvar yok edildi. Lütfen bu duvarların çok pahalı olduklarını unutmayın. Bu hasarın maliyeti ödemenizden düşülecektir."
"[english]hubannouncer_event_arcade_02"	"Analyzing. Fourth wall destroyed. Please note that these walls are very expensive. They will be deducted from your pay."
"hubannouncer_event_arcadewin_01"	"İzleyici Çekirdek yenilgiye uğratıldı. Test sonuçları analiz ediliyor: Cep Evren Laboratuvarı Sekiz'in Test Gezgini? kötü birisi."
"[english]hubannouncer_event_arcadewin_01"	"Tracer Core defeated. Analyzing test results: Test Traveller in Pocket Universe Lab Eight? is a bad dude."
"hubannouncer_event_shootbox_01"	"Cep Evren Laboratuvarı Sekiz'de maddi hasar algılandı."
"[english]hubannouncer_event_shootbox_01"	"Property damage detected in Pocket Universe Lab Eight."
"hubannouncer_event_shootbox_02"	"Canlı bebek penguen teslimatına Cep Evren Laboratuvarı Sekiz'de müdahale edildi."
"[english]hubannouncer_event_shootbox_02"	"Live baby penguin delivery interfered with in Pocket Universe Lab Eight."
"hubannouncer_event_shootbox_03"	"Cep Evren Laboratuvarı Sekiz'de iyi nişan algılandı."
"[english]hubannouncer_event_shootbox_03"	"Good aim detected in Pocket Universe Lab Eight."
"hubannouncer_event_shootbox_rare_01"	"Açıkçası, Cep Evren Laboratuvarı Sekiz'de hayran edici nişan algılandı."
"[english]hubannouncer_event_shootbox_rare_01"	"Frankly, amazing aim detected in Pocket Universe Lab Eight."
"hubannouncer_event_shootmen_01"	"Cep Evren Laboratuvarı Sekiz'de işyeri kazası oluştu."
"[english]hubannouncer_event_shootmen_01"	"Workplace accident has occurred in Pocket Universe Lab Eight."
"hubannouncer_event_shootmen_02"	"Dikkat, Cep Evren Laboratuvarı Sekiz: İşyeri güvenliği herkesin sorumluluğudur."
"[english]hubannouncer_event_shootmen_02"	"Attention, Pocket Universe Lab Eight: Workplace safety is everyone's responsibility."
"hubannouncer_event_shootmen_03"	"Uyarı, Cep Evren Laboratuvarı Sekiz: \"Kazasız Geçirilen Dakika\" Sayacı sıfırlandı."
"[english]hubannouncer_event_shootmen_03"	"Attention, Pocket Universe Lab Eight: The \"Minutes Without Accident\" Counter has been reset to zero."
"hubannouncer_event_shootmen_04"	"Uyarı, Cep Evreni Laboratuvarı Sekiz: Lütfen çalışma alanı güvenlik protokolü el kitabınızın Ek B Alt-Ek Beş kısmına bir göz atmak için zorunlu bir ara verin."
"[english]hubannouncer_event_shootmen_04"	"Attention, Pocket Universe Lab Eight: Please take a mandatory moment of reflection to review Appendix B Sub-Section Five of your workplace safety protocol manual."
"hubannouncer_event_shootmen_05"	"Uyarı, Cep Evreni Laboratuvarı Sekiz: Bir güvenlik şikayeti doldurmak için, lütfen laboratuarın çıkış kapısının hemen dışındaki Yerleşimsel Şikayet Kutusunu bulun."
"[english]hubannouncer_event_shootmen_05"	"Attention, Pocket Universe Lab Eight: To file a safety complaint, please find the Occupational Grievance Drop Box just outside the laboratory exit door."
"hubannouncer_event_shootmen_06"	"Cep Evreni Laboratuvarı Sekiz'in temizlenmesi gerekiyor. Lütfen düzenli olun."
"[english]hubannouncer_event_shootmen_06"	"Cleanup needed in Pocket Universe Lab Eight. Please be discrete."
"hubannouncer_event_shootmen_07"	"Kanıt Yok Etme Mühendisleri, yetkililerin gelmesi durumunda lütfen Cep Evreni Laboratuvarı Sekize gidin."
"[english]hubannouncer_event_shootmen_07"	"Evidence Dispersal Engineers please report to Pocket Universe Lab Eight in advance of the authorities."
"hubannouncer_event_shootmen_08"	"Cep Evren Laboratuvarı Sekiz'de kanıt dağıtımı gerekmektedir. Hızlıca."
"[english]hubannouncer_event_shootmen_08"	"Evidence dispersal needed in Pocket Universe Lab Eight. Quickly."
"hubannouncer_event_shootmen_rare_01"	"Cep Evreni Laboratuvarı Sekiz'de kötülüğün filozofik tanımı keşfedildi. Cep Evreni Laboratuarı Sekiz'e tebrikler."
"[english]hubannouncer_event_shootmen_rare_01"	"The philosophical concept of evil has just been discovered in Pocket Universe Lab Eight. Congratulations to Pocket Universe Lab Eight."
"hubannouncer_event_shootmen_rare_02"	"Cep Evren Laboratuvarı Sekiz'de cinayet icat edilmiştir. Cep Evren Laboratuvarı Sekiz'e tebrikler."
"[english]hubannouncer_event_shootmen_rare_02"	"Murder has been invented in Pocket Universe Lab Eight. Congratulations to Pocket Universe Lab Eight."
"hubannouncer_event_balloons_01"	"Cep Evren Laboratuvarı Sekiz'in atmosferinde aşırı helyum algılandı."
"[english]hubannouncer_event_balloons_01"	"Excess helium detected in atmosphere of Pocket Universe Lab Eight."
"hubannouncer_event_balloons_02"	"Uyarı: Cep Evren Laboratuvarı Sekiz'deki Helyum riskli seviyede."
"[english]hubannouncer_event_balloons_02"	"Warning: Helium levels in Pocket Universe Lab Eight are rising."
"hubannouncer_event_fetch_01"	"Cep Evren Laboratuvarı Sekiz'de eşyayı geri alma çekirdeği başarıyla test edildi."
"[english]hubannouncer_event_fetch_01"	"Item retrieval core successfully tested in Pocket Universe Lab Eight."
"hubannouncer_event_fetch_02"	"Cep Evreni Laboratuvarı Sekiz'de arkadaşlık keşfedildi. Cep Evreni Laboratuarı Sekiz'e tebrikler."
"[english]hubannouncer_event_fetch_02"	"Friendship has just been discovered in Pocket Universe Lab Eight. Congratulations to Pocket Universe Lab Eight."
"hubannouncer_event_fetch_03"	"Cep Evren Laboratuvarı Sekiz'de nesne alma eğitimi devam etmekte."
"[english]hubannouncer_event_fetch_03"	"Object retrieval training underway in Pocket Universe Lab Eight."
"hubannouncer_event_fetch_04"	"Cep Evren Laboratuvarı Sekiz'de yeni en iyi arkadaş az önce keşfedildi. Tebrikler Test Gezgini."
"[english]hubannouncer_event_fetch_04"	"New best friend has just been discovered in Pocket Universe Lab Eight. Congratulations, Test Traveler."
"hubannouncer_event_fetch_05"	"Cep Evreni Laboratuvarı Sekiz'de yapay ve uygunsuz sevgi keşfedildi. Tebrikler, Test Gezgini."
"[english]hubannouncer_event_fetch_05"	"Artificial, unconditional love has just been discovered in Pocket Universe Lab Eight. Congratulations, Test Traveler."
"hubannouncer_event_fetch_rare_01"	"İyi köpek kimmiş bakayım? Sensin. Sensin iyi köpek."
"[english]hubannouncer_event_fetch_rare_01"	"Who's a good dog? You are. You're a good dog."
"Xortex_Max"	"MAKS."
"[english]Xortex_Max"	"MAX"
"hubannouncer_event_ambient_01"	"Eşzamanlı paralel evrenler arasında kurulmuş yeni, tamamen teorik bir köprü, Cep Evreni Laboratuvarı Seksen-Beşte test edilmeye hazır."
"[english]hubannouncer_event_ambient_01"	"A new, entirely theoretical bridge between contemporaneous parallel universes is now available for testing in Pocket Universe Lab Eighty-Five."
"hubannouncer_event_ambient_02"	"Uyarı: Cep Evren Laboratuvarı Üç'ün Flamm-Krypton deneyi sizi gezegen yiyen radyoaktif bir balinanın magma dolu alt bağırsak yoluna götürecek. Test Gezginleri Flamm-Krypton Deneyi geçişini hemen durdurmamızı istemişlerdi."
"[english]hubannouncer_event_ambient_02"	"Warning: Experiment Flamm-Krypton in Pocket Universe Lab Three leads to the magma-filled lower intestinal tract of a planet-eating radioactive whale. Test Travelers are asked to immediately discontinue transit to Experiment Flamm-Krypton."
"hubannouncer_event_ambient_03"	"Uyarı. Fermi-Cathode Deneyinde negatif kütle sızıntısı. Lütfen kütle yoğunluğu sıfıra ya da sıfırın üstüne ulaşana kadar Cep Evreni Laboratuvarı Yirmi-Sekizi boşaltın."
"[english]hubannouncer_event_ambient_03"	"Warning: Negative mass leak in Experiment Fermi-Cathode. Please evacuate Pocket Universe Lab Twenty-Eight until mass density returns to zero or higher."
"hubannouncer_event_ambient_04"	"Bir sonraki bildiriye kadar tüm maddeden oluşan Test Gezginleri Sagan-Vertex deneyine girmekten kaçınmalıdır. Tüm antihidrojenden oluşan ve parçacık hızlandırmaya maruz kalan Test Gezginleri, lütfen Sagan-Vertex Deneyine rapor verin."
"[english]hubannouncer_event_ambient_04"	"Test Travelers made of matter should discontinue entering Experiment Sagan-Vertex until further notice. All partically accelerated Test Travelers made of antihydrogen please report to Experiment Sagan-Vertex."
"hubannouncer_event_ambient_05"	"Uyarı: Veriler Swan-Radar Deneyinin yerçekimsel tekilliğe gönderdiğini gösteriyor. Teorik olmayan birer kütleye sahip tüm Test Gezginleri, Swan-Radar Deneyine girmekten sakınmalıdır."
"[english]hubannouncer_event_ambient_05"	"Warning: Data suggests Experiment Swan-Radar leads to a gravitational singularity. Test Travelers with non-theoretical mass are discouraged from entering Experiment Swan-Radar."
"hubannouncer_event_ambient_06"	"Uyarı: Cep Evreni Laboratuvarı Kırk-Yedideki bir heykel bilinç kazandı ve şu anda kafası karışık ve saldırgan. Lütfen Cep Evreni Laboratuvarı Kırk-Yedideki hiçbir heykele sesinizi yükseltmeyin veya göz teması kurmayın."
"[english]hubannouncer_event_ambient_06"	"Warning: A relic in Pocket Universe Lab Forty-Seven has become self-aware and is confused and hostile. Please do not raise your voice at or make eye contact with any relics in Pocket Universe Lab Forty-Seven."
"hubannouncer_event_ambient_07"	"Bir tetra-kuarkın bir gluon ile savaşmasını izlemek isteyen tüm kuantum kromodinamik araştırmacıları, lütfen Cep Evreni Laboratuvarı Doksan-Sekize rapor edin."
"[english]hubannouncer_event_ambient_07"	"All quantum chromodynamic researchers interested in watching a tetra-quark fight a gluon, please report to Pocket Universe Lab Ninety-Six."
"hubannouncer_event_ambient_08"	"Bir sonraki bildiriye kadar \"önemli\" olarak sayılan hayati organlara sahip Test Gezginleri Kepler-Photon Deneyine gitmekten kaçınmalıdır."
"[english]hubannouncer_event_ambient_08"	"Test Travelers containing organs that would be considered 'vital' to their survival should avoid test-transit to Experiment Kepler-Photon until further notice."
"hubannouncer_event_ambient_09"	"Tehlike: Michelson-Pluto deneyi binary kodu dayalı bir yıldız sisteminde bulunuyor. Bunların ikisi de şu anda Tip Bir ve Tip Üç süpernovalar içinde patlıyorlar. Michelson-Pluto Deneyine giden tüm yollar boyunca koruyucu gözlük kullanılması tavsiye edilir."
"[english]hubannouncer_event_ambient_09"	"Warning: Experiment Michelson-Pluto leads to a binary star system, both of which are currently exploding in Type One and Type Four supernovae, respectively. Protective eyewear is recommended for all test-transit to Experiment Michelson- Pluto."
"hubannouncer_event_balloonsmax_01"	"Cep Evren Laboratuvarı Sekiz'in atmosferinde aşırı helyum algılandı."
"[english]hubannouncer_event_balloonsmax_01"	"Excess helium detected in atmosphere of Pocket Universe Lab Eight."
"Tooltip_Nav"	"Gezinme"
"[english]Tooltip_Nav"	"Navigate"
"Tooltip_GoToLab"	"Laboratuvara git"
"[english]Tooltip_GoToLab"	"Go to the Lab"
"Tooltip_PickUp"	"Seç"
"[english]Tooltip_PickUp"	"Pick Up"
"Tooltip_System"	"Sistem"
"[english]Tooltip_System"	"System"
"Tooltip_Lasers"	"Lazerler"
"[english]Tooltip_Lasers"	"Lasers"
"Slingshot_Restart"	"YENİDEN BAŞLAT"
"[english]Slingshot_Restart"	"RESTART"
"VO_Speaker_Announcer"	"Spiker: "
"[english]VO_Speaker_Announcer"	"Announcer: "
"NoScore_Offline"	"Steam Sıralama Listelerine bağlanılıyor..."
"[english]NoScore_Offline"	"Connecting to Steam Leaderboards..."
"NoScore_Unplayed"	"Sıralamanın ne olduğunu görmek için bir raunt oyna!"
"[english]NoScore_Unplayed"	"Play a round to see where you rank!"
"NoScore_Xortex"	"Bağlanılıyor..."
"[english]NoScore_Xortex"	"Connecting..."
"Planets_Mercury"	"Merkür"
"[english]Planets_Mercury"	"Mercury"
"Planets_Venus"	"Venüs"
"[english]Planets_Venus"	"Venus"
"Planets_Earth"	"Dünya"
"[english]Planets_Earth"	"Earth"
"Planets_Mars"	"Mars"
"[english]Planets_Mars"	"Mars"
"Planets_Jupiter"	"Jüpiter"
"[english]Planets_Jupiter"	"Jupiter"
"Planets_Saturn"	"Satürn"
"[english]Planets_Saturn"	"Saturn"
"Planets_Uranus"	"Uranüs"
"[english]Planets_Uranus"	"Uranus"
"Planets_Neptune"	"Neptün"
"[english]Planets_Neptune"	"Neptune"
"Window_NoHeadset"	"BAŞLIK BULUNAMADI"
"[english]Window_NoHeadset"	"HEADSET NOT FOUND"
"Window_Loading"	"YÜKLENİYOR..."
"[english]Window_Loading"	"LOADING..."
"Xortex_PickUpDroneFloater"	"GEMİNİZİ SAVUNUN"
"[english]Xortex_PickUpDroneFloater"	"DEFEND YOUR SHIP"
"Tooltip_PickUpSticks"	"Çubukları Al"
"[english]Tooltip_PickUpSticks"	"Pick Up Sticks"
}
}
