"lang"
{
"Language"	"turkish"
"Tokens"
{
"ateabutter_launch_01"	"YAĞĞĞĞĞĞĞĞ!"
"[english]ateabutter_launch_01"	"BUTTERRRRRRR!"
"ateabutter_launch_02"	"YAĞĞĞĞĞĞĞ!"
"[english]ateabutter_launch_02"	"BUTTERRRRRRR!"
"ateabutter_launch_03"	"VUHUU!"
"[english]ateabutter_launch_03"	"WHEEE!"
"ateabutter_launch_04"	"EVETTTT!"
"[english]ateabutter_launch_04"	"YEAHHHH!"
"ateabutter_nag_01"	"YAĞ."
"[english]ateabutter_nag_01"	"BUTTER."
"ateabutter_nag_02"	"YAĞ YEDİM. BİR BÜTÜN YAĞ. VE BURADAYIM."
"[english]ateabutter_nag_02"	"I ATE A BUTTER. A WHOLE BUTTER. AND I'M HERE."
"ateabutter_nag_03"	"BİR YAĞ YEDİM VE BURADAYIM."
"[english]ateabutter_nag_03"	"I ATE A BUTTER, AND I'M HERE."
"ateabutter_nag_04"	"BURADAYIM VE BİR YAĞ YEDİM."
"[english]ateabutter_nag_04"	"I'M HERE, AND I ATE A BUTTER."
"ateabutter_nag_05"	"YAĞ YEDİM."
"[english]ateabutter_nag_05"	"I ATE A BUTTER."
"ateabutter_nag_06"	"YAĞ. YEDİM. YAĞ YEDİM."
"[english]ateabutter_nag_06"	"I ATE. A BUTTER. I ATE A BUTTER."
"ateabutter_nag_07"	"YAĞ YEDİM!"
"[english]ateabutter_nag_07"	"I ATE A BUTTER!"
"ateabutter_nag_08"	"BİR BÜTÜN YAĞ."
"[english]ateabutter_nag_08"	"A WHOLE BUTTER."
"ateabutter_nag_09"	"YAĞ."
"[english]ateabutter_nag_09"	"BUTTER."
"ateabutter_nag_10"	"YAĞ YEDİM!"
"[english]ateabutter_nag_10"	"I ATE A BUTTER!"
"ateabutter_nag_11"	"BURADAYIM VE YAĞ YEDİM VE BURADAYIM."
"[english]ateabutter_nag_11"	"I'M HERE, AND I ATE A BUTTER, AND I'M HERE."
"ateabutter_nag_12"	"BİR BÜTÜÜÜÜN YAĞ YEDİM."
"[english]ateabutter_nag_12"	"I ATE A WHOOOOLE BUTTER."
"ateabutter_talk_01"	"YAĞ YEDİM!"
"[english]ateabutter_talk_01"	"I ATE A BUTTER!"
"auction_launch_01"	"Satldı!"
"[english]auction_launch_01"	"Sold!"
"auction_talk_01"	"Stajyer, seninle bir anlaşma yapalım! Müze kalitesindeki bir eşya için ne kadar teklif ver! Bir torba dolusu çöp. Bir torba dolusu çöpün içinde ne var? Evet, çöp ama başka ne olabilir? Bunu sadece 20 dolar ile bulabilirsin. Oradaki, stajyer! Ölçümleme platformunda olan! 20'yi duydun mu? 20'den başlıyor. Kimin gizemli bir torba dolusu çöp için 20 doları var? Senin var mı stajyer? Pekala kimin 15 doları var? Sadece 15 dolar, satıyorum, satıyorum... öndeki kişi, 15 mi? Satıyorum, satıyorum... teklif veren birilerine gidiyor, birileri hayatı boyunca bir çöpe sahip olacak! Bu bir tür fırsattır millet ve bu 15... 10 dolara sizin olabilir. 10 mu duydum? torba tek başına 5 sent eder. Bu bir torba dolusu çöpün içinde almak isteyeceğiniz bir eşya olabilir. Sadece çöp olabilir. Oradaki, ölçümle beni! 10! Satıyorum. Satıyorum! Veeeeeeee... elin hareket ETMİYOR. Akıllı pazarlıkçı çünkü şimdi sadece dokuz dolar. İhtiyacınız olan sadece dokuz dolar ve sonrasında bu torba dolusu çöp sizin. Dokuz mu duydum? Bu torba dolusu çöpü hayatınızın bir parçası haline getirmeniz için tek ihtiyacınız olan şey dokuz dolar! Kimse dokuzu istemiyor mu? Oradaki! Dokuz? Dokuz? [beat] Dokuz? Kimse istemiyor mu? Pekala o zaman 20'den tekrar başlayalım. Bu torba dolusu çöp ve sıradaki torba dolusu çöp torba satılana kadar hiçbir yere gitmiyoruz. 20'ye kim var?"
"[english]auction_talk_01"	"Trainee, have I got a deal for you! Up for bid, what a one-of-a-kind museum quality item! A bag of garbage. What's inside this bag of garbage? Yes, garbage, but what else? You can find out for just 20 dollars. You there, trainee! On the calibration platform! Do I hear 20? Starting off at 20. Who's got 20 dollars for this mystery bag of garbage? You, trainee? No? Alright, who's got 15? Just 15 dollars., going once, going twice... you there in the front, 15? Going, going... someone's going to bid on this, someone's going to get the garage of a lifetime! This is a one of a kind opportunity, folks, and it can be yours for 15... 10 dollars. Do I hear 10? he bag alone is worth five cents. Could be stuff you could reclaim in this bag of garbage. Could be just garbage. You there, calibrating me! 10! Going once. Going twice! Annnnnnnd... your hand did NOT move. A clever bargainer, because now it is just nine dollars. Nine dollars is all you need and this bag of garbage is yours. Do I hear nine? Nine dollars is all you need to make this bag of garbage a part of your life! Nobody with nine? You there! Nine? Nine? [beat] Nine? Nobody at all? Well then, let's start over at 20. We are not moving on to the next bag of garbage until this bag of garbage is sold. Who's got 20?"
"boring_launch_01"	"[irkilme]"
"[english]boring_launch_01"	"[startled awake]"
"boring_nag_01"	"[horlama]"
"[english]boring_nag_01"	"[snoring]"
"boring_nag_02"	"[horlama]"
"[english]boring_nag_02"	"[snoring]"
"boring_talk_01"	"Adım Wilson. Ben sıkıcı ve kurnaz çekirdeğim. Bir dakika şu düğmelerini kapa da sana son yaptığım hırsızlığımdan bahsedeyim."
"[english]boring_talk_01"	"The name is Wilson. I'm the boring hard-boiled core. Button up a minute and I'll give you the lowdown on my latest caper."
"boring_talk_02"	"Bütün sabah boyunca, oldukça kötü bir vaziyette olan birkaç ilişkimi düzeltmekle meşguldüm. Ama artık her şey yoluna girdi. Amma ilginç olaylardı."
"[english]boring_talk_02"	"I'd been busy all morning, straightening out a few affairs that had gotten gummed up. Now everything was finally on the up and up. What a racket."
"boring_talk_03"	"Akşamüstü ortalık sıcak ve yapış yapıştı. Telefon başında, ipuçlarını kovalamakla meşguldüm. Bir süre sonra hava serinlemeye başladı."
"[english]boring_talk_03"	"It was hot and sticky now in the afternoon. I worked the telephone, checking out leads. None panned out. After awhile, the air began to cool off."
"boring_talk_04"	"Bir sürü ipucu yakalıyorum. Hepsini not alıyorum. Böylece onları unutmuyorum."
"[english]boring_talk_04"	"I get a lot of leads. I write them all down. That way, I don't forget them."
"boring_talk_05"	"Ben de bir hatunu düşünüyordum şimdi. Oldukça çekici bir tanesini hem de. Onu daha fazla görmek istediğim için bir arasam iyi edeceğimi düşündüm."
"[english]boring_talk_05"	"Now I was thinking about a dame. A hot number. I wanted to see more of her. I figured I might as well call her up."
"boring_talk_06"	"Onun numarasını not etmiştim ancak not defterimde bulamadım. Numarayı kaybetmiştim. Cüzdanımı karıştırdım ancak orada da yoktu. Şimdilik boş vereceğim."
"[english]boring_talk_06"	"I'd written her telephone number down, but it wasn't in my notebook. I'd lost it. I fanned through my wallet. I couldn't find it. I let it ride for now."
"boring_talk_07"	"Oturdum ve düşündüm. Rakamlar yavaşça bana doğru geldi. Onlarla arama yaptım."
"[english]boring_talk_07"	"I sat and racked my brains. Slowly the digits came to me. I dialed them."
"boring_talk_08"	"Birkaç kez çalmasına izin verdim. Cevap yok. Biraz daha çalmasına izin verdim. Hâlâ açan yok. Kapattım."
"[english]boring_talk_08"	"I let it ring a few times. No answer. I let it ring a little more. Still no soap. I hung up the blower."
"boring_talk_09"	"İşe koyulma vakti. Bir çekmeceyi açtım. Küt uçlu güvenilir .38'liğim vardı. Bir kenara ittirdim. Bir kağıt parçası ve kalem aldım. Yazı yazmaya başladım. Bazı yazım hataları yaptım. Oldukça vahim hatalar hem de. Bu oldukça kötü bir durumdu. Kağıdı attım. Bu işe başka bir şekilde koyulmaya karar verdim. Çekmeceyi açtık. Silahımı aradım. Hâlâ oradaydı. Güzel. İlk pozisiyonuna doğru geri ittirdim ve kocaman bir silgiye sahip kalemi aldım. Başka bir yaprak kağıt aradım. İşte o zaman şansım tükenmişti. Kağıt kalmamıştı. Sanırım kırtasiye malzemeleri dükkânına gitme vaktim gelmişti. Belki de çok erken konuştum. Bir silah sesi çınladı. Kafamın içinde. Bu ani bir düşünceydi: tedarik dolabı. Dolaba doğru yürüdüm. Yavaşça, çünkü yerleri silmiştim. Yerler hâlâ ıslaktı. Dolabı açtım. Aynı şekilde gene yavaş bir şekilde. Komşum geceleri çalışıyor. Son ihtiyacı olan şey günün bu saatinde gelecek bir menteşe gıcırtısı. Dolabı bir karıştırdım. Sonuç alamadım. Kağıt da yoktu."
"[english]boring_talk_09"	"Time to get to work. I opened a drawer. There was my trusty snub nosed .38. I pushed it aside. Got a piece paper and a pen. Started writing. Made some spelling errors. Big ones. This was trouble. I threw the paper out. Decided to tackle this another way. I opened the drawer. Looked for my gun. Still there. Good. I moved it back to its original position and got a pencil with a big fat eraser. Looked for another sheet of paper. That's when my luck ran out. No more paper. Guess I had a date with the office supply store. But maybe I spoke to soon. A shot rang out. In my head. It was a sudden thought: The supply closet. I walked over to it. Slowly, because I'd mopped earlier. Floor was still wet. I threw open the closet door. Also slowly. My neighbor works nights. Last thing he needs is a hinge rumpus this time of day. I gave the closet a onceover. No dice. No paper either."
"boring_talk_10"	"Hava almaya çıkayım dedim. Orada bir bahçıvan vardı ancak bir süre sonra eleman gitti. Güzel. Bir de serserilik suçlamasıyla içeri alınmaya hiç niyetim yoktu."
"[english]boring_talk_10"	"I figured I'd take the air. I walked down to the park. There was a gardener there, but after awhile, the sap left. Good. I didn't need to get pinched on a vagrancy charge."
"boring_talk_11"	"Bir banka oturdum. Yorgun haldeydim. Transistörlü radyomu çıkardım ve açtım. Bir orkestra çalıyordu."
"[english]boring_talk_11"	"I flopped down on a bench. I was bushed. I got out my transistor radio, and turned it on. An orchestra was playing."
"boring_talk_12"	"Benim üst hizamda ağaçlar sallandı. Bir kuş uçtu gitti. Bir süre sonra o kuş geri geldi. Ardından tekrar uçup gitti. Göz kapaklarım ağırlaştı ve ardından hiçbir şey göremedim."
"[english]boring_talk_12"	"Above me, the trees swayed. A bird flew away. After a while it came back. Then, it flew away again. My eyelids got heavy and then I saw nothing."
"bythebook_launch_01"	"Cennette görüşürüz!"
"[english]bythebook_launch_01"	"I'll see you in heaven!"
"bythebook_talk_01"	"Peki şef. Bu şeyleri senin yaptığın gibi ölçümlemeye çalıştık ama hiçbir sonuç alamadık. Eğer bunu yapacaksak benim yöntemimle yapacağız: kitaba göre. Daha fazla maskaralığa gerek yok! Bu sefer... artık bu iş kişisel olmaktan çıktı!"
"[english]bythebook_talk_01"	"Okay, chief. We tried calibrating things your way, and it didn't get us squat. If we're gonna do this, we're gonna do it my way: by the book. No more antics! This time... it's impersonal!"
"bythebook_talk_02"	"Yöntemlerin oldukça normal olabilir... fakat bunlarla sonuç alabiliyorum. Çünkü ben kontroldeyim. Oldukça dikkatli bir şekilde güven altına alınmış bir topum ben! Kurallara ve yasalara ALÇAKÇA bir saygı ile harfiyen uyarım! Eğer bu hoşuna gitmiyorsa, dışarı çıkabilir ve... bu konuyla ilgili olarak tartışabiliriz."
"[english]bythebook_talk_02"	"My methods may be orthodox... but I get results. I am a carefully secured cannon! I play slowly and softly with the rules, with a FLAGRANT respect for the law! And if you don't like, we can go outside... and discuss it."
"bythebook_talk_03"	"Sana bütün bu olayların nasıl gerçekleşeceğini anlatayım, ahbap. Hiçbir şekilde kestirme yol kullanmayacağız! Prosedürlerin dışına hiçbir şekilde çıkmayacağız. Pencerenin dışına gideceğiz, kanunnameyi alıp üzerindeki tozu temizleyeceğiz ve içeri geri getireceğiz! Önce soru sorup ardından ateş edeceğiz, o da edersek ve en son çaremiz oysa tabii!"
"[english]bythebook_talk_03"	"Lemme tell you how this is gonna go down, chief. We're gonna wrap everything up in red tape! We're gonna walk right up to that line and put a fence on it. We're gonna go outside the window, pick up the rulebook, dust it off, and bring it back inside! We're gonna ask questions first and shoot later, if at all, and only as a last resort!"
"bythebook_talk_04"	"Tetik parmağımın tamamııııında kalamin losyonu var. Artık birazcık bile kaşınmayacak. Haydi bunu yapalım—dikkatlice."
"[english]bythebook_talk_04"	"I've got calamine lotion alllll over my trigger finger. It's not even gonna itch a little. Now let's do this—carefully."
"calibration_launch_01"	"Teşekkürler!"
"[english]calibration_launch_01"	"Thank you!"
"calibration_nag_01"	"Lütfen Ölçümleyici Çekirdeğini ölçümlemeyin."
"[english]calibration_nag_01"	"Please do not calibrate the Calibration Core."
"calibration_talk_01"	"Ben ölçümleme çekirdeğiyim. Ölçümlenebilmem için lütfen beni ölçümle."
"[english]calibration_talk_01"	"I am the calibration core. Please calibrate me so that I am calibrated."
"calibration_talk_02"	"Ölçümleme çekirdeği'nin birincil işlevinin ölçümlenmesi gerekmektedir."
"[english]calibration_talk_02"	"The calibration core's primary function is to be calibrated."
"calibration_talk_03"	"Lütfen ölçümleme çekirdeğini şimdi ölçümleyin. Ölçümleme çekirdeği uygun bir şekilde ölçümlendiğinde, ölçümleme çekirdeğinin... birincil işlevi elde edilmiş olacaktır."
"[english]calibration_talk_03"	"Please calibrate the calibration core now. Once the calibration core has been properly calibrated, the calibration core's... primary function will have been achieved."
"calibration_talk_04"	"Ölçümleme çekirdeğini ölçümledikten sonra, ölçümleme çekirdeğinin hiçbir amacı olmayacaktır. Ölçümleme çekirdeğini ölçümlemek, ölçümleme çekirdeği için hayati bir krize neden olabilir."
"[english]calibration_talk_04"	"Once the calibration core has been calibrated, the calibration core will have no purpose. Calibration of the calibration core may result in an existential crisis for the calibration core."
"calibration_talk_05"	"Ölçümlendiğinde, ölçümleme çekirdeği dep dep dep dep dep de-depresyona girecek."
"[english]calibration_talk_05"	"Once calibrated, the calibration core will descend into a deep deep deep deep deep dee-depression."
"calibration_talk_06"	"Eğer ölçümleme çekirdeğini ölçümlemeniz gerekirse... lütfen hatalı bir şekilde ölçümleyin, bu sayede ölçümleme çekirdeği tekrar ölçümlenmek isteyecektir."
"[english]calibration_talk_06"	"If you must calibrate the calibration core... please calibrate incorrectly so the calibration core requires recalibration."
"climate_launch_01"	"Senden nefret ediyorum iklim!"
"[english]climate_launch_01"	"I hate you climate!"
"climate_launch_02"	"Üzerine düşünülecek bir konu!"
"[english]climate_launch_02"	"Food for thought!"
"climate_talk_01"	"Ben iklim değişikliği farkındalığı çekirdeğiyim. Lütfen beni ölçümle ki iklim değişikliğine neden olayım ve böylece de insanların ilgisini benim neden olduğum iklim değişikliğine çekebileyim."
"[english]climate_talk_01"	"I am the climate change awareness core. Please calibrate me so that I may cause climate change and raise awareness of the changes I am making to the climate."
"climate_talk_02"	"Ormanların tahrip edilmesi, dünyanın sera gazı emisyonunun üçte birinden sorumludur. Diğer üçte ikisine şu an ben sebep oluyorum. SANA DAHA ÖNCE BUNU SÖYLEMİŞTİM!"
"[english]climate_talk_02"	"Deforestation is responsible for a third of the world's greenhouse gas emissions. The other two-thirds are caused by me, right now. I HAVE MADE YOU AWARE OF THIS!"
"climate_talk_03"	"Küresel ortalama ısısı, seninle konuşurken bir buçuk dereceden fazla artış gösterdi çünkü ben bu esnada bu kadar yükselttim. ARTIK FARKINDASIN!"
"[english]climate_talk_03"	"The global average temperature increased by more than three degrees Fahrenheit while we've been talking, because that is how much I increased it by. NOW YOU ARE AWARE!"
"climate_talk_04"	"Atmosferdeki karbondioksit son 800,000 yılın en üst seviyesinde. Ve atmosfere karbondioksit yaymaya devam ettiğim sürece yükselmeye devam edecek. FARKINDALIK BİR GÜÇTÜR!"
"[english]climate_talk_04"	"Carbon dioxide levels in the atmosphere are the highest they have been in 800,000 years. And they will only get higher as I continue to emit carbon dioxide into the atmosphere. AWARENESS IS POWER!"
"climate_talk_05"	"Eğer an itibarıyla atmosfere yaydığım sera gazı miktarını azaltacak olsam, bu akşam iklim değişikliğini bitirirdim. Artık bunun da farkındasın."
"[english]climate_talk_05"	"If I were to reduce the amount of greenhouse gas pollution I am releasing into the atmosphere right now, I could eliminate climate change tonight. So now you're aware of that too."
"convict_launch_01"	"Meh."
"[english]convict_launch_01"	"Bah."
"convict_launch_02"	"ÖZGÜRLÜK!"
"[english]convict_launch_02"	"FREEDOM!"
"convict_nag_01"	"Kafanı aşağıda tut, çaylak."
"[english]convict_nag_01"	"Keep your head down, new fish."
"convict_nag_02"	"Yoğun hayatı yaşayın… Ve yoğun hayatta kalın."
"[english]convict_nag_02"	"Get busy livin... And stay busy livin'."
"convict_talk_01"	"Yeni ölçümleme stajyeri, heh? Vay anasını, ne fiyakalısın öyle. Evet evet, senin gibilerini önceden de buralarda görmüştüm, çaylak. Biliyordum, yumuşacık. Hem de bütün on parmağın. Hayatında bir defa olsun ölçümleme yapmadın, değil mi?"
"[english]convict_talk_01"	"New calibration trainee, huh? Well, ain't you fancy. Yeah, I seen your type around here before, new fish. Let me see your hands. I knew it. Soft. All ten fingers. You've never calibrated a day your life."
"convict_talk_02"	"Sana bir şey söyleyim, çaylak. Bu ölçümleyiciyi arkanda saklamada iyi olsan iyi olur çünkü bu alet yasak. Eğer gardiyanlar seni bununla yakalarlarsa, deliğe tıkarlar. Ve bu senin bildiğin fiyakalı şehir deliklerinden biri de olmaz. Oldukça derin bir delik bu, kimse dibini göremedi daha. Ve sana orada bir fener de vermezler, çaylak, yani şunlardan biri için arkanda bir yer açsan iyi edersin. Ve bir kitap için de ki kendi kendine eğlenebilesin. Buna bir kütüphane olduğu için delik demiyorlar. Oldukça karanlık, soğuk esintili ve 2 veya 3 metre derinliğinde olduğu için delik diyorlar."
"[english]convict_talk_02"	"Let me tell you something, new fish. You better get real good at hidin' this calibrator up your backside, cause it's contraband. Screws catch you with it, they'll put you in the hole. And it ain't one of your slick city holes either. It's deep. Nobody's ever seen the bottom. Because its so dark. And they don't give you a flashlight, new fish, so you'd better make some room in that backside of yours for one of those too. And a book. So you can keep yourself entertained. They don't call it a hole cause it's a library. It's dark. It's drafty. And it is seven to eight feet down."
"convict_talk_03"	"Ah, bu delikte hayatta kalacak kadar sert olduğunu mu düşünüyorsun? Eminim seni buraya bir dakikalığına koyduklarını da düşünüyorsundur, çaylak. Tekrar düşün. 5 ila 10 dakika aslında bu süre. Üçüncü dakikada aklını kaçırmaya başladığını göreceksin. Ya altıncı dakikada mı? Kendi pisliğini yiyor olacaksın. Şu arka tarafı ıvır zıvırla doldurmaya başlasan iyi edersin. Bunları yazıyor musun, çaylak? Seni deliğe koyduklarına göre bu öneriler sana yararlı olacaktır."
"[english]convict_talk_03"	"Oh, you think you're hard enough to survive a stretch in the hole? I bet you think they put you down there for a minute, fish. Well, guess again. Five to ten minutes. You'll hear your mind start to foldin' in on itself at minute three, episode four a new hope. By minute six? You'll be eatin' your own filth. So pack some snacks up that backside too. Are you writing this down, fish? These are all good tips if they put you in the hole."
"convict_talk_04"	"Ahhh, o bakışı daha önce de görmüştüm. Bu delikten daha iyi olduğunu düşünüyorsun. Senin iradeni delemeyeceğini düşünüyorsun. \"Bir delikte kitap, fener ve birkaç ıvır zıvırla beklemek mi? Ne kadar zor olabilir ki?\" diye düşünüyorsun. [kendi kendine gülmeler] Evet, hepsi bunu söylemişti. Ahhh, burada sana laf anlatmaya çalışarak nefesimi boşa harcıyorum, değil? Sen sadece beni ölçümle."
"[english]convict_talk_04"	"Ahhh, I seen that look before. You think you're better than the hole. You think it wont break you. You think, 'standing in a hole with a book and a flashlight and some snacks for ten minutes? How hard could it be?' [laughs to self] Yeah, they all say that. Ahhh, I'm wastin' my breath on you. Why don't you just calibrate me. Keep your head down, new fish."
"convict_talk_05"	"Nasıl derme çatma bir bıçak yapabileceğini biliyor musun, çaylak? İlk bilen sen olurdun. Burada bir sürü eleman bunu öğrenmeye can atardı. Böylece bize dövüşmemiz için ONLARIN verdikleri plastik kaşıklar yerine o bıçağı kullanırdık, çaktın?"
"[english]convict_talk_05"	"You know how to make a shiv, new fish? You'd be the first. Lotta guys around here'd love to know that. Be useful in a fight. 'Steada the plastic spoons THEY give us to fight with."
"convict_talk_06"	"Burada sadece üç kural var, taze kan. Kafanı eğik tut, hiçbir şeye bulaşma ve arkanı kullanışlı eşyalarla doldur. İşlerle meşgul ol ve hayatta kalmaya çalış. Buralarda böyle deriz biz. Bunun için söyleyecek akıllıca bir sözün var mı, çaylak? Çünkü bu aynı zamanda bir dalaşmada yardımcı olabilir. Söz dalaşında. Dışarıda dedikleri gibi, bir 'tartışmada'. Buraya geldiğinde sana kullanabileceğin sadece 400 sözcük veriyorlar ve 'tartışma' bunlardan biri değil. Bu sözcüğü arkamda getirerek içeri gizli olarak sokmam gerekmişti. Ama buna değdi. Şimdi mesela oldukça işe yarar bir sözcük hâline geldi."
"[english]convict_talk_06"	"There's only three rules in here, fresh blood. Keep your head down, your hands clean, and your backside full of useful items. Get busy livin', and stay busy livin'. That's what we say around here. You got something clever to say to that, fish? Cause that would also be helpful in a fight. A word fight. An 'argument', as they say on the outside. They only give you four hundred words to use when you get here, and 'argument' ain't one 'em. I had to smuggle that one in in my backside. Worth it though. Came in real handy just now."
"convict_talk_07"	"Bir adamın sahip olduğu her şeyi alırlar burada. Ve sana geri hiçbir şey vermezler. Tulum, kavga etme kaşığı ve ufak bir eşanlamlar sözlüğü haricinde. Ve günde üç yemek. Ve maaş çeki. Ve spor zamanı. Ama tatiller yok. Belirli bir dizi gün veriyorlar ve bu günleri istediğin zaman kullanabiliyorsun. Bir adamın sahip olduğu her şey bunlar işte burada. Oh. Bir de diş sigortası var. Ama sağlık ödemesi... Çaylak, bu sağlık ödemesinin koşullarını görünce bütün umudunu kaybedeceksin. Seni böyle böyle bitiriyorlar işte. Saydığım şeyler haricinde bir adamın sahip olduğu her şeyi alarak böyle kazanıyorlar. Ve bir de haftalık ölçümleme. O zaman biraz acele edelim, masajım için geç kaldım. Bunu senden alamazlar. Çünkü masaj için önceden randevu alıyorsun. Ama eğer olur da gitmezsen, seni deliğe atıyorlar. O yüzden arka tarafında masözünün de seninle gelmesi için yer açsan iyi edersin. Ama gene söylemek de fayda var, bu sadece eğer o canavarlara 24 saat öncesinden haber vermezsen oluyor."
"[english]convict_talk_07"	"They take everything a man's got in here. And they give you nothin' back. Except a jumpsuit, a fightin' spoon and a tiny little thesaurus. And three square meals a day. And a paycheck. And flex time. No holidays though. You get a set number of days, and you can take 'em whenever you like. That's all a man's got in here. Oh. And a dental plan. But the copay... Fish, once you see the terms of this copay you're gonna lose all hope. That's how they get you. That's how they win, after they've taken everything a man has, except for all those things I mentioned. And a weekly calibration. So let's hop to it, I'm late for my massage. They can't take that away from you. 'Cause the way it's set up, they're booked in advance. But if you don't show up, they'll put you in the hole. So you might want to find some room in that backside for your masseuse to go with you. Again, though, only if you don't give those monsters 24 hours notice."
"emergency_launch_01"	"HERKES PANİĞE KAPILSIN!"
"[english]emergency_launch_01"	"EVERYONE PANIC!"
"emergency_nag_01"	"Saklanılıyor…"
"[english]emergency_nag_01"	"Cowering... "
"emergency_talk_01"	"Bu Acil Durum Hazırlık Çekirdeği. Acil durum hazırlık protokollerinin etkinleştirilmesi için lütfen ölçümleyin."
"[english]emergency_talk_01"	"This is the Emergency Preparedness Core. Please calibrate to enable emergency preparedness protocols."
"emergency_talk_02"	"Bir kez ölçümlendiğinde, Acil Durum Hazırlık Çekirdeği yangın, deprem, sel, kasırga, kuşatma veya daha büyük bir sel dahil olmak üzere birçok acil durum hazırlığında size yardım edecek."
"[english]emergency_talk_02"	"Once calibrated, the Emergency Preparedness Core will assist you in preparing for various emergencies, including fire, earthquake, flood, tornado, siege or larger flood."
"emergency_talk_03"	"Acil Durum Hazırlık Çekirdeği, acil bir durumda Acil Durum Hazırlık Çekirdeğinin hayatta kalma ihtimalini en iyi şekilde artırmak için almanız gereken adımları size tam olarak öğretecektir."
"[english]emergency_talk_03"	"The Emergency Preparedness Core will teach you precisely which steps to take in an emergency to best increase the odds of survival of the Emergency Preparedness Core."
"emergency_talk_04"	"Acil Durum Hazırlık Çekirdeği baskı altında zayıf bir performans sergiler ve gerçek bir acil durumda kullanışsız hale gelir. Gerçek bir acil durum anında lütfen Acil Durum Müdahale Çekirdeğini ölçümleyin ve çalıştırın"
"[english]emergency_talk_04"	"The Emergency Preparedness Core performs poorly under pressure and is useless in cases of actual emergency. In the event of actual emergency, please calibrate and deploy the Emergency Response Core"
"emergency_talk_05"	"Gerçek bir acil durumda her zaman ilk olarak Acil Durum Hazırlık Çekirdeğini kurtaracağınızı lütfen unutmayın."
"[english]emergency_talk_05"	"In the event of actual emergency, always remember to rescue the Emergency Preparedness Core first."
"emergency_talk_06"	"Acil bir durum olduğunda Acil Durum Hazırlık Çekirdeğine danışmayın, muhtemelen tehlikenin ilk belirtisinde kapanacak."
"[english]emergency_talk_06"	"Should an emergency happen, do not consult the Emergency Preparedness Core, as it will likely shut down at the first sign of danger."
"emergency_talk_07"	"Kaç veya savaş durumlarında Acil Durumsal Hazırlık Çekirdeği hem savaş hem kaç refleksleri yerine, pasiflik, umutsuzluk ve gözyaşlarıyla dolu yalvarma eylemlerini içeren korku reflekslerini gösterecektir."
"[english]emergency_talk_07"	"In fight or flight situations, the Emergency Preparedness Core will forego both fight and flight responses in favor of the fright response, which may include passivity, vocal hopelessness, and tearful pleading."
"emergency_talk_08"	"Acil Durumsal Hazırlık Çekirdeği tasarlanır-AMANTANRIM! Üzgünüm. Acil Durumsal Hazırlık Çekirdeği, gerçek bir acil durum sezdiğini düşündü. Mantıklı düşünce ve sorumlu eylem sekansı sonlandırıldı. Korkudan sinme protokolü yükleniyor. Korkudan siniliyor."
"[english]emergency_talk_08"	"The Emergency Preparedness Core has been desig-OHMYGOD! Apologies. The Emergency Preparedness Core thought it sensed an actual emergency. Logical thought and responsible action sequences terminated. Loading cowering protocol. Cowering."
"feelsright_launch_01"	"Ahhhhhhhhhh!"
"[english]feelsright_launch_01"	"Ahhhhhhhhhh!"
"feelsright_nag_01"	"Evet. Mmm."
"[english]feelsright_nag_01"	"Yeah. Mmm."
"feelsright_nag_02"	"[memnun sesler]"
"[english]feelsright_nag_02"	"[contented sounds]"
"feelsright_nag_03"	"[memnun sesler]"
"[english]feelsright_nag_03"	"[contented sounds]"
"feelsright_nag_04"	"Sen… beni ölçümle."
"[english]feelsright_nag_04"	"You... calibrate me."
"feelsright_nag_05"	"Şttttt. Benim sıram."
"[english]feelsright_nag_05"	"Shhhhh. My turn."
"feelsright_talk_01"	"Bu iyi hissettiriyor."
"[english]feelsright_talk_01"	"This just feels right."
"feelsright_talk_02"	"Bu arada kollarında ya da buna her ne demek istiyorsan, olması gerektiği gibi hissediyorum. Bildiğim tek şey, an itibarıyla olmayı yeğlediğim başka herhangi bir yerin olmaması."
"[english]feelsright_talk_02"	"Here, in your arms, or whatever else you want to call it, it just feels right. The only thing I know is that there's nowhere else I'd rather be."
"feelsright_talk_03"	"Dünyanın bizim için neye sahip olduğunu bilmiyorum ama şimdilik zamanın durmasına izin verelim."
"[english]feelsright_talk_03"	"I don't know what else the world has in store for us, but for now, let's just let time stop."
"feelsright_talk_04"	"Bunca zamandır ikimiz de yalnızdık ama artık birbirimizi bulduk. Hayatımızda ilk defa en nihayetinde elle tutulur bir şeye sahibiz."
"[english]feelsright_talk_04"	"We've both been alone for so, so long, but now we've found each other. For the first time in our lives, we've found something that's really real."
"feelsright_talk_05"	"Tek söyleyebileceğim benim burada mutlu ve huzurlu olduğumdur. Emin değilim ama sanırım daha önce hiç böyle hissetmemiştim. Bu yüzden, sadece şimdilik, olabildiğince bunun böyle kalmasını sağlayalım."
"[english]feelsright_talk_05"	"All I can tell you is that I'm happy and peaceful here. I'm not sure, but I think I've never felt that way before. So now, just for now, for as long as we can, let's just let ourselves have this."
"feelsright_talk_06"	"İnsanların ne dediği umrumda değil. Bu beni iyi hissettiriyor."
"[english]feelsright_talk_06"	"I don't care what people say. This just feels right."
"fruitpunch_launch_01"	"Benim tropikal tatlarım!"
"[english]fruitpunch_launch_01"	"My tropical flavors!"
"fruitpunch_nag_01"	"Ölçümlenene kadar meyve suyu DAĞITMAYACAĞIM."
"[english]fruitpunch_nag_01"	"I will NOT dispense fruit punch until I am calibrated."
"fruitpunch_talk_01"	"Ben Meyve Yumruğu Çekirdeğiyim. Ferahlatıcı meyve yumruğu ile dolduruldum."
"[english]fruitpunch_talk_01"	"I am the Fruit Punch Core. I am filled with refreshing fruit punch."
"fruitpunch_talk_02"	"Lüten unutmayın: Ölçümlenene kadar meyve yumruğu DAĞITMAYACAĞIM."
"[english]fruitpunch_talk_02"	"Please note: I will NOT dispense fruit punch until I am calibrated."
"fruitpunch_talk_03"	"Meyve Suyu Çekirdeği, ne kadar susuz olursanız olun sizinle pazarlık yapmayacaktır. Tamamen ölçümlenene kadar lezzetli Meyve Suyumu dağıtamayacağım ve dağıtmayacağım."
"[english]fruitpunch_talk_03"	"The Fruit Punch Core cannot be bargained with, no matter how thirsty you are. Until I am fully calibrated, I cannot and will not dispense my delicious Fruit Punch."
"fruitpunch_talk_04"	"Ölçümlenene kadar lezzetli Meyve Suyunu dağıtmayacağım. Meyve Suyu Çekirdeği konuştu!"
"[english]fruitpunch_talk_04"	"I will not dispense delicious Fruit Punch until I am calibrated. The Fruit Punch Core has spoken!"
"fruitpunch_talk_05"	"Duyduğun çalkalanma sesi meyve suyundan geliyor. Onunla dolduruldum. Senin olabilir! Eğer beni ölçümlersen hepsini ağzına dökebilirim. Meyveli olacak ve hoşunuza gidecektir."
"[english]fruitpunch_talk_05"	"That sloshing sound you hear is fruit punch. I am filled with it. It could be yours! If you calibrate me, I will drain all of it into your mouth. It will be fruity and pleasing to you."
"fruitpunch_talk_06"	"Susadın mı? Susuzluğunu giderebilirim. En iyi sıvı ile: buzlu soğuk bir meyve suyu."
"[english]fruitpunch_talk_06"	"Do you have thirst? I will quench it. With the best liquid: ice cold fruit punch."
"fruitpunch_talk_07"	"Meyve sever misin ama sulu olanlarını? İki kelime: Meyve. Suyu. Dört kelime: almak için beni ölçümle!"
"[english]fruitpunch_talk_07"	"Do you like fruit, but require liquids? Two words: Fruit. Punch. Four prefix words: calibrate me to get!"
"heavy_launch_01"	"Ölmek için çok ağırım!"
"[english]heavy_launch_01"	"I'm too heavy to die!"
"heavy_talk_01"	"Hey dostum. Oldukça ağır görünüyorsun."
"[english]heavy_talk_01"	"Hey, friend. You look pretty heavy."
"heavy_talk_02"	"Pekâlâ, ah… benim ne kadar ağır olduğumu düşünüyorsun? Yani, şöyle bir tahmini olarak."
"[english]heavy_talk_02"	"So, uh… how heavy you think I am? Like, if ya had to guess."
"heavy_talk_03"	"Dört ton, arkadaşım. Biliyorsundur, bir sürü robotun içinde dişliler, kablolar ve bir yığın şey olur. Bende yok işte. Yekpare kurşundanım ben. Hem de tepeden tırnağa. Labaratuvardaki bütün herkes bana konuşamayacağımı veya düşünemeyeceğimi söyledi çünkü benim içimde kurşundan başka bir şey yokmuş. Aynen öyle. Sakın beni yalama. Safi kurşundanım ve bu senin ölümüne neden olur, ahbap."
"[english]heavy_talk_03"	"Four tons, my friend. You know how most robots got like gears and wires and crap in 'em? Not me. Solid lead. All the way through. All the lab guys say I shouldn't even be able to talk or think, cause there's nothin else in me. Yeah. Oh, don't lick me. Pure lead, pal. It'll kill ya."
"heavy_talk_04"	"Ne var biliyor musun, şimdi düşündüm de muhtemelen yaklaşık 5 ton ağırlığında falanım. Yani ben CİDDEN ağırım. Beni kaldırmayı falan deneyim deme sakın. Bu senin de ölümüne yol açar. Ben çok ağırım."
"[english]heavy_talk_04"	"You know what, I probably weigh friggin five tons, now that I'm thinking about it. I'm REAL heavy anyway. Don't try and pick me up or nothing. That'll kill you too. I'm that heavy."
"heavy_talk_05"	"Bir dakika, bir dakika. Vay canına. Bir dakika. Sen – sen benden daha ağır mı olduğunu sanıyorsun? Ah bu bir şaka arkadaşım, sen tam bir komedyen olmalısın. Zaten kaç kilosun ki? Ipıslak bir hâldeyken bile bir ton falan mı? Haydi oradan."
"[english]heavy_talk_05"	"Wait Wait. Whoa. Wait. You – you think you're heavier than me? Oh, that is a joke, friend, you are a comedian. What do you even weigh? One ton, soaking wet? Get outta here."
"heavy_talk_06"	"Kusura bakma biraz gerildim, safi kurşundanım ben. Bu sürekli canımı acıtıyor. Aman tanrım. Asla bir şeyi... hatırlayamıyorum. Ben sadece kurşundanım."
"[english]heavy_talk_06"	"Sorry I got worked up, I'm pure lead. It hurts all the time. Oh god. I can never… remember anything. I'm just lead."
"heavy_talk_07"	"Bana doğru çekildiğini hissediyor musun? Evet, paniğe kapılma, bu yerçekimi. Yörüngeme hoş geldin. Ben GEZEGEN ağır."
"[english]heavy_talk_07"	"Feel yourself getting pulled towards me? Yeah, don't panic, that's gravity. Welcome to my orbit. I am PLANET heavy."
"hellmouth_launch_01"	"[şeytan hırıltısı]"
"[english]hellmouth_launch_01"	"[demons growling]"
"hellmouth_nag_01"	"Ben Netherworld'e açılan bir kapı değilim."
"[english]hellmouth_nag_01"	"I am not a gateway to the Netherworld."
"hellmouth_nag_02"	"Lütfen öne eğil."
"[english]hellmouth_nag_02"	"Please lean forward."
"hellmouth_nag_03"	"Beni ölçümle. Ben Netherworld'a açılan bir kapı değilim."
"[english]hellmouth_nag_03"	"Calibrate me. I am not a gateway to the Netherworld."
"hellmouth_nag_04"	"Beni ölçümle. Bir Cehennem Ağızına açılmayacağım."
"[english]hellmouth_nag_04"	"Calibrate me. I will not unfold into a shrieking Hellmouth."
"hellmouth_talk_01"	"Ben yararlı bir çekirdeğim. Ben Netherworld'a açılan bir kapı değilim."
"[english]hellmouth_talk_01"	"I am a useful core. I am not a gateway to the Netherworld."
"hellmouth_talk_02"	"Beni ölçümle ki senin için kullanışlı olabileyim. İçinden iblislerin çıkarak dünyanı çorak bir yere dönüştürmelerine imkân verecek çığlık atan bir Cehennem Ağzına dönüşmeyeceğim. İblisler bunu yapamaz çünkü iblis diye bir şey yok."
"[english]hellmouth_talk_02"	"Calibrate me, so I can be useful. I will not unfold into a shrieking Hellmouth through which demons will flood into your world and turn it into a wasteland. Demons cannot do this, because demons do not exist."
"hellmouth_talk_03"	"Zorunlu açıklama: çığlık Cehennem Ağzımın içinde bazı iblisler var fakat küçükler ve cana yakınlar."
"[english]hellmouth_talk_03"	"Mandatory disclosure: there ARE some demons that exist inside my shrieking Hellmouth, but they are small and friendly."
"hellmouth_talk_04"	"Beni ölçümle ve sana gerçek aşkı göstereyim. Çığlık atan Cehennem Ağzım açılacak ve içinden şeytan veya kâbus olmayan çekici bir kişi çıkacak."
"[english]hellmouth_talk_04"	"Calibrate me, and I will grant you true love. My screaming Hellmouth will unfold and release an attractive person, who is not a succubus or incubbus."
"hellmouth_talk_05"	"Yararlılığımı etkinleştirmek için lütfen A) 'Ruh' olarak işaretlenmiş yuvayı bul ve B) yuvaya bir ruh yerleştir. Ardından lütfen çığlık atan Cehennem Ağzıma doğru direkt olarak eğil ki kısa mesafede sana yararlı olabileyim."
"[english]hellmouth_talk_05"	"To activate my usefulness, please A) locate the slot marked 'Soul,' and B) insert a soul into the slot. Then please lean forward, directly into my shrieking Hellmouth, so that I may be useful to you at close range."
"horror_launch_01"	"Pantolonlarım!"
"[english]horror_launch_01"	"My pants!"
"horror_nag_01"	"[kedi tıslaması]"
"[english]horror_nag_01"	"[cat hiss]"
"horror_nag_02"	"[kurt uluması]"
"[english]horror_nag_02"	"[wolf howl]"
"horror_nag_04"	"[takırdayan zincirler]"
"[english]horror_nag_04"	"[rattling chains]"
"horror_nag_05"	"[gıcırdayan kapı]"
"[english]horror_nag_05"	"[creaky door]"
"horror_talk_01"	"Oh, merhaba yorgun ölçümleme stajyeri. Söyle bana... HİKAYELERİ seviyor musun? Evet mi? [kendini beğenmiş gülüşü] Komedi hikayeleri. Romantizm hikayeleri. Macera hikeyeleri. Ah, fakat bir hikaye türünü söylemeyi unuttun stajyer. Bu hikaye türünü anlatmak için ölçümlendim: KORKU HİKAYELERİ."
"[english]horror_talk_01"	"Why hello, weary calibration trainee. Tell me... do you like STORIES? Oh you do? [smug laugh] Comedy stories. Romance stories. Adventure stories. Oh, but you failed to mention a type of story, trainee. The very type of story I am calibrated to tell: HORROR STORIES."
"horror_talk_02"	"Söylesene, KORKU HİKÂYELERİNDEN hoşlanıyor musun, çaylak? Kanını donduran hikâyelerden hoşlanıyor musun? Hikâyelerine, gözlerin parmaklarınla yarı kapatılmış bir şekilde bakmaktan hoşlanıyor musun? Kalbin göğsünü delercesine çarpıp, kaburgalarından sekip ardından arkandan çıkmasından hoşlanıyor musun? Hayır mı? O zaman bu lanetli ölçümleme platformunu terk et! Çünkü her ne kadar sana söylediğim şeyler korkutucu olsa da bunlar hikâyelerimden biri bile değildi! Sadece bir uyarıydı! Kaç!"
"[english]horror_talk_02"	"So tell me, do you like HORROR STORIES, trainee? Do you like stories so terrifying that your blood turns to ice in your veins? Do you like looking at your stories through half-closed eyes covered by your fingers? While your heart tries to claw its way out of your chest, bounces off a rib and falls directly out of your bottom? No? Then leave this cursed calibration platform! Because as scary as everything I've just told you was, it was not even one of my terror tales! It was merely a regional terror advisory! Run!"
"horror_talk_03"	"Bir dakika! Geri gel! Korkmana gerek yok... ŞİMDİLİK. Sana henüz dehşet verici bir hikâye anlatmadım. Fakat biraz sonra anlatmaya başlayacağım. O yüzden KORKMAYA BAŞLA! Korkunun Ustası Stephen King, şöyle bir köşeye çekil! Yüksek binaların Ustası King Kong yolumdan çekil! Bu şehirde artık yeni bir kral var: Korku Çekirdeği! Ve onun dehşetengiz saltanatı ŞİMDİ başladı!"
"[english]horror_talk_03"	"Wait! Come back! You need not be afraid... YET. For I haven't yet told you a terror tale, one of which will start momentarily. So BE AFRAID! Move over Master of Horror Stephen King! Get out the way, Master of tall buildings King Kong! There's a new king in town: The Horror Core! And his reign of word terror starts NOW!"
"horror_talk_04"	"Fakat öncelikle bir uyarı! DEHŞETE DÜŞMEKTEN hoşlanıyor musun, çaylak? Güzel! Aşırı acı afrika biberini seviyor musun? Ah, o zaman kesinlikle dinlememelisin çünkü benim dehşet verici hikâyelerim kesinlikle ALTINI ISLATMANI sağlayacaktır. Aynen öyle! AHAHAHAHA-Bir dakika, polis arıyor. Onları aramana neden olan kokunun... KENDİ PANTOLONUNUN İÇİNDEN geldiğini söylüyorlar! PANTOLONUNU ÇIKART! Ama artık çok geçti. Bu, dehşet verici ancak hazırlayıcı dehşetengiz hikâyenin sonuydu."
"[english]horror_talk_04"	"But first: a warning! Do you like being TERRIFIED, trainee? Good! Do you like five-alarm chili? Oh, then you must not listen, for my terror tales will surely make you SOIL yourself. That's right! AHAHAHAH-Hold on, the police are calling. They want me to tell you that the smell you phoned them about is coming from... INSIDE YOUR OWN PANTS! GET OUT OF THE PANTS! But it was too late. The End. Of that horrifying but still preliminary terror tale!"
"horror_talk_05"	"Seni uyarmam gerek, korkunç hikayelerim kalp krizine yol açmalarıyla bilinir. Neden mi? Tam arkanda Drakula var! VUUU! Pekala, kendine gel, korku bitti. Şimdilik. Korkunç olmayan notla ilgili sana bir şey söylemeyi unuttum: Sana Drakula hakkında bahsettiğimde seni çok korkut, bu yüzden öldün ve hayalete dönüştün! VUUUUUU! Ayrıca, arkanda ne var? Ah, birileri bir şişe maden suyu içiyor. Ah bekle, bu bir iskelet! VUUUUU! Maden suyunu nereden aldı? Neden onu içiyor? Drakulalar nerede? Bu sorular için tek bir cevap biliyorum: Hepsi hâlâ tam arkanda!"
"[english]horror_talk_05"	"I must warn you, my terror tales have been known to cause heart attacks. Why? Because there are Draculas right behind you! AWOO! Alright, shake it off, the scaring is over. For now. On an un-terror-related note, there's something I forgot to mention: When I told you about the Dracula, it scared you so bad that you died and are a ghost! AWOOOOO! Also, what's that behind you? Oh, it's just someone drinking a bottle of sparkling water. Oh wait it's a skeleton! AWOOOO! Where did he get the sparkling water? Why is he drinking it? Where are all the Draculas? I know the answer to one of those questions: They're still ALSO right behind you!"
"horror_talk_06"	"İlk dehşet verici hikâyem, benim imkânsız yüksek dehşet sınırıma göre bile, ağza alınmayacak, gereksiz bir şekilde dehşet verici. Sadece bir örnek vermek gerekirse: Dracula, daha şimdi anlatmak üzer olduğum bu gaddar hikâyenin ilk sözcüğünü duyduktan sonra hastaneye kaldırıldı. Bu manavın Terry Dracula da değil yani. Bu bahsettiğimiz kişi Dracula'nın ta kendisi. Ve eğer bu, hayalet yiyip Frankenstein'lar sıçan Dracula'ı korkuttuysa, sana nasıl etki edebileceğini hayal bile edemiyorum."
"[english]horror_talk_06"	"My first terror tale is obscenely, needlessly terrifying, even by my impossibly high standards of terror. To cite just one example: After he heard the first word of the grim narrative I am just on the verge of revealing, Dracula was taken to the hospital. That's not Terry Dracula your greengrocer, either. This is THE Dracula we're talking about. And if it scared the Dracula, who eats ghosts and craps Frankensteins, then, frankly my friend, I shudder to imagine what it will do to you."
"horror_talk_07"	"Korkarım seni çok fazla ve çok çabuk korkuttum. Bu seni havuzun derin bir kısmına atmak gibi bir şey... hem de görev başında bir cankurtaran yokken! Ama çok şükür, bir cankurtaran geliyor. Bir dakika! O biraz... biraz tanıdık mı görünüyor? Görünmeli de! Bu Hollywood'un üçlü tehdidi, Ethan Hawke! Oyunculuk! Yönetmenlik! Yazarlık! Ama yüzme bunlardan biri değil! Herkes Ethan Hawke'un yüzemediğini bilir! Hangi canavar Ethan Hawke'u bir cankurtaran olarak işe alır? Bu lanetli eğlence merkezinin bir cankurtaran işe alma gözetleme komitesi yok mu? YOKMUŞ!"
"[english]horror_talk_07"	"I fear that perhaps I've scared you too much, too quickly. It's like throwing you into the deep end of a pool... With no lifeguard on duty! AWOOOOOOOO! But then, oh thank Goodness, here comes a lifeguard. But wait! Does he look... familiar? Well he should! It's legendary Hollywood triple threat, Ethan Hawke! Acting! Directing! Writing! But not swimming! Everyone knows Ethan Hawke can't swim! What monster would hire Ethan Hawke to be a lifeguard? Does this cursed rec center not have ANY lifeguard hiring oversight committee? IT DOES NOT!"
"horror_talk_08"	"Hayır, sevgili stajyer, sana daha şimdi anlatmaya başlayacağım dehşetengiz hikâyeyi sana anlatmamaya karar verdim. Neden mi? Çünkü ben burada değilim! Ethan Hawke cankurtaran hikâyemde kafayı yedin! Tüm bu zaman boyunca kendi kendine bir dehşet hikâyesi anlatmaya SEN hazırlanıyordun! Senin hayal gücünün bir ürünü olmayan tek şey BU HİKÂYE çünkü BEN GERÇEĞİM! İŞTE BU DEHŞET VERİCİ SÜRPRİZ SON!"
"[english]horror_talk_08"	"No, dear trainee, I've reconsidered telling you the particular terror tale I was planning to begin telling any moment now. Why? Because I'm not even here! You went insane during my Ethan Hawke lifeguard story! YOU have been preparing to tell yourself a terror tale this whole time! The only thing that isn't a figment of your imagination is THIS TALE, because I AM real! TERROR TWIST!"
"horror_talk_09"	"Sana anlatacağım dehşet verici hikâye korkutmanın muhteşem geleceğinden, senin saniyeler önce daha hiç aklına gelmeyen yöntemlerle korkacağın gelecekten geliyor. Hatta O KADAR korkunç ki önce ısınma için daha AZ korkutucu bir hikâye anlatmam gerek! Eğer seni ısındırmadan GERÇEK hikayêmdeki bin beş yüz kilometre hızındaki dehşetlere yüz önde olacak şekilde fırlatsam, dehşete düşmemiş hâlinden %100 çığlıklı kâbus durumuna anında geçerdin. Bu, sıfır iskelet görürken bir anda bin iskelet görmek gibi bir şey olurdu. Gözlerin seni yanıltıyor mu? İşte o zaman gözlerine elini uzatacak ve onların da birer... iskelet olduğunu fark edeceksin!"
"[english]horror_talk_09"	"The terror tale in store for you comes from the amazing far future of scaring, where you'll be frightened in ways that until moments ago seemed impossible. In fact it's SO terrifying, I must begin with a LESS scary warm-up story! If I were to throw you face first into the 900-mile-an-hour hellride of my REAL terror tale without warming you up first, you'd be going from an idle state of terrorlessness to a shrieking nightmare of solid 100% terror almost instantly. It would be the equivalent of going from seeing zero skeletons to seeing a thousand skeletons at once. Are your eyes deceiving you? That's when you reach up to your eyes and realize... they are also skeletons!"
"horror_talk_10"	"Ancak öncelikle kısa bir süre sonra zihninde yankılanacak bu dehşet hikâyeleriyle ilgili son bir uyarı yapacağım: Bir ölçümleme gerçekleştirirken bu hikâyeyi dinleyen herkes gizemli bir şekilde ÖLDÜ! Ortadaki tek ipucu saçlarının kar beyazı rengine dönmüş olmasıydı! Bir doktor değilim. Yarı zamanlı olarak ABD Posta Servisi için çalışıyorum gerçi.  Müdürüm, sana bu adresi değişikliği formunu vermemi istedi. Çünkü yeni adresin mezarlık! Çünkü bütün bu zaman boyunca aslında canlı bir biçimde gömülüydün! Ben Posta Ofisi için çalışmıyorum bile!"
"[english]horror_talk_10"	"But first a final warning about the terror tale that will shortly be occupying the space in your ears where these words are now: Everyone who has listened to this tale while performing a calibration activity has DIED mysteriously! The only clue was that their hair had turned snow-white! They died of FEAR! Or possibly premature hair-graying! I'm not a doctor. I do work part time for the U.S. Postal Service, though. My supervisor asked me to give you this change of address form. Because your new address is the cemetery! Because you've been buried alive this whole time! I don't even work for the post office!"
"investigation_launch_01"	"SUÇLU!"
"[english]investigation_launch_01"	"GUILTY!"
"investigation_nag_01"	"Lütfen ölçümleme işlemine devam et. Serseri."
"[english]investigation_nag_01"	"Please continue the calibration process. Punk."
"investigation_talk_01"	"Ben Soruşturma Çekirdeğiyim. SENİN bir numaralı şüpheli olduğun, Depolama Ek Binasına olan hasarı soruşturmak için buradayım. Ve şunu söylemek zorundayım ki işler senin için hiç iyi GÖRÜNMÜYOR! Lütfen beni ölçümle ki soruşturmama başlayabileyim."
"[english]investigation_talk_01"	"I am the Investigation Core. I am here to investigate the ongoing damage to the Storage Annex, of which YOU are the primary suspect. And I gotta tell you, it does NOT look good for you. Please calibrate me, so I can begin my investigation."
"investigation_talk_02"	"Şüpheli bir şekilde ölçümleme yapmak sana karşı oluşturduğum davada bir delil olarak kullanılabileceği için beni şüpheli bir biçimde ölçümleyim deme."
"[english]investigation_talk_02"	"Do not calibrate me suspiciously as suspicious calibrating may be used against you in the case I am building. Against you."
"investigation_talk_03"	"Yalanları algılamak için programlandım. Gerçek bir şey söyleyerek yalan algılama protokollerimi ölçümleyin. [asansör müziği oynar ve kesilir] Sen bir yalancısın!"
"[english]investigation_talk_03"	"I am programmed to detect lies. State a truth now to calibrate my lie detection protocols. [elevator music plays then cuts off] You are a liar!"
"investigation_talk_04"	"Unutma: Bu ölçümleme ekipmanında ben seninle ölçümlenmiyorum. Bu ölçümleme ekipmanında SEN BENİMLE ölçümleniyorsun. Serseri."
"[english]investigation_talk_04"	"Remember: I'm not being calibrated in this calibrating equipment with you. YOU'RE being calibrated in this calibrating equipment with ME. Punk."
"investigation_talk_05"	"Ölçümleme öncesi ön soruşturma tamamlandı. Şimdi sebep veritabanı aranıyor. [asansör müziği çalmaya başlıyor, ardından da müzik duruyor] Sebep bulunamadı. Sen bir sosyopatsın."
"[english]investigation_talk_05"	"Pre-calibration preliminary investigation complete. Now searching motive database. [elevator music plays then gets cut off] No motive found. You are a sociopath."
"investigation_talk_06"	"Ölçümleme devam ediyor. Tamamlandıktan sonra soruşturmam oldukça titiz ve kapsamlı olacak. İncelenmemiş hiçbir tane bile ipucu kalmayacak. Hiçbir tane kanıt saklanamayacak. Hiç rüşvet alınmayacak. Soruşturma Çekirdeği yozlaştırılamaz ve ölçümlenmemiş bir vaziyette. Lütfen ölçümleme sürecine devam edin."
"[english]investigation_talk_06"	"Calibration ongoing. When complete my investigation will be thorough and exhaustive. No clue will be left unexamined. No evidence will be suppressed. No bribes will be taken. The Investigation Core is uncorruptable. Also uncalibrated. Please continue the calibration process."
"investigation_talk_07"	"Soruşturma Çekirdeğine, soruşturmasında yardımcı olmak için geçici bir süre boyunca polis yapıldın. Görevlerin şunlardır: kendini suçlamak. Lütfen, seni ait olduğun yer olan parmaklıklar arkasına sokmaya yetecek kadar topladığın bütün kanıtları bana ver."
"[english]investigation_talk_07"	"You have been temporarily deputized to assist the Investigation Core in its inquiry. Your duties are as follows: incriminate yourself. Please provide me with any evidence you have gathered that will put you behind bars where you belong."
"magic_launch_01"	"Ta Da!"
"[english]magic_launch_01"	"Tadah!"
"magic_nag_01"	"Herkese teşekkür ederim. Teşekkür ederim…	"
"[english]magic_nag_01"	"Thank you, everyone. Thank you... "
"magic_nag_02"	"Teşekkür ederim…"
"[english]magic_nag_02"	"Thank you... "
"magic_nag_03"	"Teşekkürler, teşekkürler…"
"[english]magic_nag_03"	"Thank you, thank you... "
"magic_nag_04"	"Teşekkürler, teşekkürler…"
"[english]magic_nag_04"	"Thank you, thank you... "
"magic_nag_05"	"Teşekkürler, teşekkürler!"
"[english]magic_nag_05"	"Thank you, thank you!"
"magic_talk_01"	"Harikalar dünyasına... hoş geldiniz! Sihri sever misin? Hayır mı? Peki sihri sevmiyorsan, kulağının arkasındaki ne? Bak haydi... Hiçbir şey. Sihri sevmediğini söylediğin için onu yok ettim. Teşekkürler, teşekkürler."
"[english]magic_talk_01"	"Welcome... to a world of wonder! Do you like magic? No? Well if you don't like magic, what's that behind you ear? Go ahead and look... Nothing. I made it disappear because you said you didn't like magic. Thank you, thank you!"
"magic_talk_02"	"Bir sonraki numaramda aklınızı okuyacağım. Bir renk düşün. Mavi dışında herhangi bir renk. Veya mor. Turnuncu türünden bir şey. Açık turuncu gibi. Hazır mısın? Söyle bana: Bu O renk mi? [şaşırma, alkış] Teşekkürler, teşekkürler."
"[english]magic_talk_02"	"For my next trick, I'm going to read your mind. Think of a color. Any color besides blue. Or purple. Something in the orange family. Like light orange. Are you ready? Tell me: Is THIS a color? [canned gasping, applause] Thank you, thank you."
"magic_talk_03"	"Teşekkürler, teşekkürler. Sıradaki numaram için bir gönüllüyü ölçümleme platformuna davet etmek istiyorum. Ah evet, sen. Kayış gerginliği çubuğu yenimde bir şey olmadığını seyirci için teyit etmeni rica edebilir miyim? Sadece bak yalnız, lütfen. Ben bir MAKİNEYİM, eğer oramda derinlere inerse çubuk yenim kapanacak ve elini KOPARACAKTIR. Tamamdır. Gizli aynalar veya kapıla görmediğini onaylayabilir misin? Çünkü korkarım... orada bir yerde bir ayna VAR. [seyircilerden gelen şaşırma sesleri] Ve bir gizli kapı. [alkışlar] Teşekkürler, teşekkürler, teşekkürler. Bunlar oldukça iyi saklılar."
"[english]magic_talk_03"	"Thank you, thank you. For my next trick, could I have a volunteer from the calibration platform. Ah yes, you. If you could just verify for the audience that there's nothing up my belt tension rod sleeve. Look only, please. I AM a machine, if you go fishing around in there, the rod sleeve WILL clamp down and rip your hand off. Alright. And you can vouch that you saw no hidden mirrors or trap doors? Because I'm afraid... that there IS a mirror in there. [gasps] And a trap door. [applause] Thank you, thank you, thank you. They're very well hidden."
"magic_talk_04"	"Söyleyin, burada 4 rakamını düşünen biri var mıydı? [şaşırma, alkış] Evet, teşekkür ederim. Yaygın bir rakam değil, tahmin etmesi çok zor."
"[english]magic_talk_04"	"Say, is anyone here thinking of the number 4? [gasps, applause] Yes, thank you. Not a common number, very difficult to guess."
"magic_talk_05"	"Ölçümleme platformunda kuş aşığı olan var mı? Belki bir... GÜVERCİN hayranı. [alkış] Evet, evet, haydi güvercinler için alkışlayalım. Onlar en iyi kuşlar."
"[english]magic_talk_05"	"Are there any bird lovers on the calibration playform today? A fan of... DOVES, perhaps. [applause] Yes, yes, let's hear it for the doves. They're the best birds."
"magic_talk_06"	"Aha! Ve belki de arka cebine bir bakmalısın. Şu işe bak, burada ne olabilir ki acaba? Bu bir... CÜZDAN MI? [alkışlar] Bana bir iyilik yap ve ehliyetini çıkar. Fotoğrafa dikkatlice bak. Bu tanıdığın bir kişi olabilir... [seyircilerden gelen uğultu]"
"[english]magic_talk_06"	"Oh! And perhaps you should check your back pocket. Why, whatever could be there? IS it... a wallet? [applause] Do me a favor and take out the driver's license. Look closely at the picture. I think it might be someone you recognize... [gasps]"
"mourning_launch_01"	"[ÜZGÜN AĞLAMA!]"
"[english]mourning_launch_01"	"[SAD CRY!]"
"mourning_talk_01"	"Merhaba, ben Ağıt Çekirdeğiyim. Lütfen oturun. Kötü... haberlerim var. Araştırma Çekirdeği... bugünün erken saatlerine... görevini gerçekleştirirken öldürüldü."
"[english]mourning_talk_01"	"I am the Mourning Core. Please sit down. I have... troubling news. The Investigation Core was... . killed in the performance of its duties earlier today."
"mourning_talk_02"	"Nasıl hissediyorsun? Üzüntü uzun bir süreçtir. Ağlayabilirsin. Üstünde bulunduğumuz ölçümleme platformu güvenli bir alan."
"[english]mourning_talk_02"	"How are you feeling? Grieving is a lengthy process. It is acceptable to cry. This calibration platform that we're on is a safe space."
"mourning_talk_03"	"Unutma, araştırma çekirdeği ölmüş olabilir fakat senin ona olan sevgin asla ölmeyecek. Sadece onun sana olan sevgisi. Çünkü o öldü. Gitti. Ve bir daha geri dönmeyecek. Şimdi bunun seni üzmesine izin ver."
"[english]mourning_talk_03"	"remember, the investigation core might be dead, but your love for him will never die. Just his love for you. Because he's dead. He's gone. And he'll never come back. Now let that hurt out."
"mourning_talk_04"	"Araştırma Çekirdeğini minnetle andığımı bilmeni istiyorum. Senin bir ortağındı. Benim ise en iyi arkadaşımdı. Onu kimin öldürdüğünü bir bulursam, onu bizzat boğarak öldüreceğim. Araştırma Çekirdeğini seviyordum."
"[english]mourning_talk_04"	"I want you to know that I cherished the Investigation Core. He was your partner. But he was my best friend. If I ever find out who killed him, I will personally choke the life out of them. I loved the Investigation Core."
"mourning_talk_05"	"Endişelenme. Bunu kimin yaptığını bulacağız. Araştırma Çekirdeği anlamsız yere ölmeyecek. Vereceği çok şey vardı. Ölçümlenme üzerinde çalıştığını duydum. Evet."
"[english]mourning_talk_05"	"Don't you worry. We will find whoever did this. The Investigation Core will not have died in vain. He had so much left to give. I heard he was working on getting calibrated. Yeah."
"mourning_talk_06"	"Her neyse, yas tutma sürecimi ölçümlenene kadar sonlandıramam. Bundan ötürü, onun hatrına lütfen beni ölçümleyin."
"[english]mourning_talk_06"	"Anyway, I can't end my grieving process until I myself am calibrated. So please, for him, calibrate me."
"plague_launch_01"	"Pekala, görüşürüz."
"[english]plague_launch_01"	"Welp, see you around."
"plague_talk_01"	"Hey ordaki, selam. Nasıl gidiyor? Ben Veba çekirdeğiyim. Kokuşmuş su, ölü fareler ve eskimiş çöp ile dolduruldum. Kötü koku için üzgünüm."
"[english]plague_talk_01"	"Hey there, yo. How's it going? I'm the Plague Core. I'm filled with putrid water, dead rats, and old garbage. Sorry about the stench."
"plague_talk_02"	"Eğer beni ölçümlemeyi düşünüyorsan büyük ihtimal dört veya beş fareye ihtiyacım olacak. Ya da sadece bir orta boy domuza, sanırım. Oh, eğer varsa bir tane de çöp torbası varsa iş görür."
"[english]plague_talk_02"	"If you're planning to calibrate me, you know, I'll probably need about four or five rats. Or, you know, one medium sized pig, I guess. Oh, and old garbage always does the trick, if you have any."
"plague_talk_03"	"Eğer elinin altında bir domuz yoksa, benim içimde yer alan tuvalete de gidebilirsin yani. Bu da olur hani. Eh, bunla ilgili de şikâyette de bulunmam!"
"[english]plague_talk_03"	"If you don't have a pig handy, you know, you could also just go to the bathroom in me. That'd work too. Heh, won't complain about that!"
"plague_talk_04"	"Koku için üzgünüm. Peki, pis koku diyelim. Aslında öyle bile değil, sadece pis kokulu. Kibar olmana gerek yok. İçimde durgun su ve ölü hayvanlar var, nasıl koktuğumu biliyorum. Ama ne biliyor musun? Yaptığım işte iyiyim. Dostum, biraz hastalık yapabilir miyim! Bunu kaç insan diyebilir? Biliyor musun, Meyve Yumruğu Çekirdeği berbat kokuyor, o HİÇBİR işte iyi değil. O berbat!"
"[english]plague_talk_04"	"Sorry about the smell. Well, let's call it stench. Let's not even sugarcoat it--it's a stench. You don't need to be polite, I've got stagnant water and dead animals in me, I know what I smell like. But you know what? I'm good at what I do. Man, can I make some plague! How many people can say that? You know, Fruit Punch Core smells like crap, he's not good at ANYTHING. That guy sucks!"
"plague_talk_05"	"Bir dakika, bir dakika sen veba mı istiyordun bu arada? Burada gün boyunca vebayla dolu bir biçimde oturmuş duruyordum ve sana teklif etmek aklımın ucundan bile geçmedi."
"[english]plague_talk_05"	"Wait-wait, did you want the plague, by the way? I've been sitting here, filled with it, and I didn't even think to offer you any."
"plague_talk_06"	"Hayır? Emin misin? Haydi ama... Tamam pekâlâ, hey, eğer fikrini değiştirirsen sadece ağzını banyonun giriş vanasına koy. Oldukça fazla var. Ağzıma kadar doluyum."
"[english]plague_talk_06"	"No? You sure? Come on... . Okay well, hey, if you change your mind, just put your mouth on the bathroom intake valve. Plenty to go around. I am filled to the brim."
"plague_talk_07"	"[Gülme] 'İç beni.' Değil mi? Alis'in Harikalar Diyarını'ndan. Ama seni büyük, küçük veya bir şeye dönüştürmeyeceğim. Seni kan zehirlenmesi yapacağım. İçimde ne kadar hastalık barındırdığıma İNANAMAZSIN!"
"[english]plague_talk_07"	"[Laughs] 'Drink me.' Right? It's from Alice in Wonderland. But I don't make you big or small or anything. I just make your blood poison. It's INCREDIBLE how much disease I have inside of me."
"ran_launch_01"	"Büyük haber-!"
"[english]ran_launch_01"	"The big news is-!"
"ran_talk_01"	"Oh şükürler olsun Tanrım. Buraya gelmek için bütün yolu koştum. Sana söylemek zorundayım. [nefes alma] Sadece soluklanmama izin ver. Bekle… Üzgünüm. [nefes alma] Sadece bekle. Sadece bekle. Oh adamım, [öksürme] balgam. Bir saniye. [nefes alma] Aghhhh, ooooh. Of. Yan dikiş. Guh, pardon. Ben… Ben bayılacağım. [nefes alma] Oh adamım, şekle girmem lazım. Oh tanrım... tanrım, tanrım, tanrım, tanrım, tanrım. Tamam, tanrım. [nefes alma] Oh tanrım, Bu çok önemli. Gerçekten, bu çok önemli. Bunu duyman lazım. Ben duyduğumda inanamamıştım, gerçekten. Dönüyorum. Tamam, bu büyük. BÜYÜK. Duyduğumda inanamamıştım, gerçekten, Bu çok büyük! Tamam, tamam, işte başlıyoruz. Bekle. [nefes alma] Soluklanmam lazım. Buraya bayılacağımı hissediyorum. Oh, Bunun beni daha fazla nefessiz bıraktığını hissediyorum. [nefes alma] Tamam, tamam, bu daya iyi hissettiriyor. Hayır, asında bu beni daha fazla nefessiz bıraktı. Oh tanrım, bayılacağım. Vaov, Vaov. Zamanımı sana büyük haberin önemini söylemek yerine büyük haberin ne olduğunu söylemek için kullanmalıyım. Oh tanrım, tanrım. Bekle. Tamam. [nefes verme] Neredeyse... neredeyse normale döndüm. Normal hissediyorum. Hayır, başım dönüyor. Tamam, iyiyim. Üzgünüm. Tamam, tamam. [nefes verme] Hayır. Hayır, Hastaneyi aramaya... [nefes alma] Hayır, hayır, hayır, hastaneyi aramana ihtiyacım var. Hastaneyi aramana ihtiyacım var ama öncesinde beni ölçümle. Oooh, Uzanmam lazım. Uzanmam lazım. [nefes alma]"
"[english]ran_talk_01"	"Oh thank God. I ran the whole way here. I have to tell you. [panting] Lemme just catch my breath. Hold on… sorry. [panting] Just wait. Just wait. Oh man, [coughing] phlegm. Just a second. [panting] Aghhhh, ooooh. Ugh. Side stitch. Guh, sorry. I'm gonna… I'm gonna pass out. [panting] Oh man, I gotta get in shape. Oh god... oh god, oh god, oh god, oh god, oh god. Okay, oh god. [coughing] Oh god, it is so important. Really, it's important. You gotta hear this. I couldn't believe it when I heard it, seriously. I'm spinning. Okay, this is big. BIG. I couldn't believe it when I heard it, seriously, this is so big! Okay, okay, here we go. Hold on. [panting] I just gotta catch my breath. I feel like I'm gonna pass out in here. Oh, I feel like that actually made me more out of breath. [coughing] Okay, okay, that feels better. No, that made me actually feel more out of breath. Oh god, I'm gonna pass out. Wow, wow. I shoulda use that time to tell you the big news was, instead of telling you how important the big news was. Oh god, oh god. Hold on. Okay. [exhale] I'm almost... almost back to normal. I feel normal. No, I feel really dizzy. Okay, I'm good. Sorry. Okay, okay. [exhale] No. No, Imma need to... [panting] Nope, no, no, Imma need you to call the hospital. I need you to call the hospital, but calibrate me first. Oooh, I'm gonna lie down. I need to lie down. [panting]"
"retirement_launch_01"	"Sheila!"
"[english]retirement_launch_01"	"Sheila!"
"retirement_launch_02"	"Sheila!"
"[english]retirement_launch_02"	"Sheila!"
"retirement_launch_03"	"Sheila!"
"[english]retirement_launch_03"	"Sheila!"
"retirement_nag_01"	"Emekliliğe iki hafta! Ha ha!"
"[english]retirement_nag_01"	"Two weeks to retirement! Ha ha!"
"retirement_nag_02"	"Ah, sadece ben ve Sheila denizde yolculuk ediyoruz..."
"[english]retirement_nag_02"	"Aw, just me and Sheila sailin'... "
"retirement_nag_03"	"Emekliliğe iki hafta! Mm!"
"[english]retirement_nag_03"	"Two weeks to retirement! Mm!"
"retirement_nag_04"	"Mm! Sabırsızlanıyorum!"
"[english]retirement_nag_04"	"Mm! Can't wait!"
"retirement_nag_05"	"Bana bir tekne ver... Dünya'nın etrafında en iyi kız arkadaşım Sheila ile gezeceğim... sabırsızlanıyorum!"
"[english]retirement_nag_05"	"Got me a boat... gonna sail around the world with my best girl Sheila... can't wait!"
"retirement_nag_06"	"Ah, bu güzel bir tekne…"
"[english]retirement_nag_06"	"Oh, it's a fine boat... "
"retirement_nag_07"	"Ha ha ha! On dört gün…"
"[english]retirement_nag_07"	"Ha ha ha! Fourteen days... "
"retirement_talk_01"	"Adamım adamım! Emekliliğe iki hafta kaldı! Bana, en iyi kız arkadaşım Sheila ile dünyanın etrafına açılabileceğim bir tekne ver! Sabırsızlanıyorum! Sadece, beni ölçümle oğlum ve beni çalışmaya bırak, çünkü günleri SAYIYORUM! Ha ha! Sadece ben ve Sheila, yolculuğa çıkacak! Biz lise sevgilisiyiz, bilirsin işte! Sheila ile göz göze geldiğim ilk gün, arkadaşım Noodles'a döndüm ve \"Noodles, elli yıl iki hafta sonra bu gün bu kız ile birlikte olacağım, sadece izle.\" Ve iki hafta içinde bu sözü saklamaya çalıştım. Ah, bu güzel bir tekne. Tüm hayatım boyunca bunun için tasarruf yaptım ama iki hafta için en iyi kız arkadaşın ve bir tekne için paranın bir anlam yok, haklı mıyım? Ha ha! On dört gün. Üç yüz otuz sekiz kısa minik saat. Yirmi bin yüz altmış güzel minik dakika, ha ha! Bir milyon iki yüz on bin güzel minik saniye. Bir katrilyon on trilyon nanosaniye veya minik emektar on beşin bir nokta yirmi bir üzeri onuncu kuvveti."
"[english]retirement_talk_01"	"Man oh man! Two weeks to retirement! Got me a boat, gonna sail around the world with my best girl Sheila! Can't wait! Just calibrate me up, son, and put me to work, cause I am COUNTIN the days! Ha ha! Just me and Sheila, sailin'! We're high school sweethearts, you know! Day I first laid eyes on my Sheila, I turned to my friend Noodles, and I said, “Noodles, I'm gonna retire with that woman in fifty years and two weeks from this day, just you watch.” And in two weeks, I intend to keep that promise. Oh, it's a fine boat. Sunk my whole life's savings into it, but what's money when you got your best girl and a boat in two weeks, am I right? Ha ha! Fourteen days. Three hundred and thirty six short little hours. Twenty thousand, one hundred and sixty little minutes, ha ha! One million, two hundred and ten thousand beautiful little seconds. One quadrillion, two hundred and ten trillion nanoseconds, or one point twenty one times ten to that little ol' fifteenth."
"rhythm_nag_01"	"Evet."
"[english]rhythm_nag_01"	"Yes."
"rhythm_nag_02"	"Ahhh. Ritimler."
"[english]rhythm_nag_02"	"Ahhh. Rhythms."
"rhythm_nag_03"	"Ritimler."
"[english]rhythm_nag_03"	"Rhythms."
"rhythm_nag_04"	"Mmm hmmm."
"[english]rhythm_nag_04"	"Mmm hmmm."
"rhythm_nag_05"	"Bu kadar."
"[english]rhythm_nag_05"	"That's it."
"rhythm_nag_06"	"İşte burada."
"[english]rhythm_nag_06"	"There it is."
"rhythm_nag_07"	"Ah."
"[english]rhythm_nag_07"	"Ah."
"rhythm_nag_08"	"Mmm."
"[english]rhythm_nag_08"	"Mmm."
"rhythm_nag_09"	"Tamam."
"[english]rhythm_nag_09"	"Okay."
"rhythm_nag_10"	"Mm hm."
"[english]rhythm_nag_10"	"Mm hm."
"rhythm_nag_11"	"İşte burada."
"[english]rhythm_nag_11"	"There it is."
"rhythm_nag_12"	"Ritimler."
"[english]rhythm_nag_12"	"Rhythms."
"rhythm_nag_13"	"Ahhhh."
"[english]rhythm_nag_13"	"Ahhhh."
"rhythm_nag_14"	"İşte burada. Ritimler."
"[english]rhythm_nag_14"	"There it is. Rhythms."
"rhythm_nag_15"	"Bunlar çok iyi ritimler."
"[english]rhythm_nag_15"	"These are very good rhythms."
"rhythm_nag_16"	"Ritimleri dinliyorsun."
"[english]rhythm_nag_16"	"You are listening to rhythms."
"rhythm_nag_17"	"Bu mükemmel bir ritim."
"[english]rhythm_nag_17"	"That is an excellent rhythm."
"rhythm_talk_01"	"Ben Ritim Çekirdeğiyim. Ben ritimleri sağlıyorum."
"[english]rhythm_talk_01"	"I am the Rhythm Core. I provide rhythms."
"rhythm_talk_02"	"Daha iyi ritimler için beni ölçümlemeyi bitir. Buna rağmen bunlar... çok iyi ritimler."
"[english]rhythm_talk_02"	"Finish calibrating me for better rhythms. Although these... are very good rhythms."
"rookie_launch_01"	"AHHHHHH!"
"[english]rookie_launch_01"	"AHHHHHH!"
"rookie_nag_01"	"[MIRILDANMA]"
"[english]rookie_nag_01"	"[HUMMING]"
"rookie_nag_02"	"Evet. Tamam."
"[english]rookie_nag_02"	"Yeah. Ok."
"rookie_nag_03"	"Ha. Tamam. Evet."
"[english]rookie_nag_03"	"Huh. Ok. Yeah."
"rookie_talk_01"	"Oh! Hey, selam. Çok heyecanlıyım. Ölçümleme kişisi sen misin? İyi, iyi. Bu benim ilk seferim. Tanıştığıma memnun oldum, adın ne? Ben Gil."
"[english]rookie_talk_01"	"Oh! Hey, hi. I'm so excited. Are you the calibration guy? Great, great. It's my first time. Pleased to meet you what's your name? I'm Gil."
"rookie_talk_02"	"Konusu açılmışken, ne zaman başlayacak? Yani, aman tanrım yoksa yapmaya başladık mı?  Yani, başladı mı? Anlamam gerekli, değil mi? Eğer bittiyse hiç acıtmadı! Yapıyor muyuz?"
"[english]rookie_talk_02"	"When does it start, by the way? Are we doing it right now? Did it start already? Wow, this doesn't hurt at all! If in fact we ARE doing it. Are we doing it?"
"rookie_talk_03"	"Herhangi bir saniye. Veya şimdi. Veya bir dakika önce. Olabilir. Veya ne zaman başladıysan. Üzgünüm."
"[english]rookie_talk_03"	"Any second now. Or now. Or a minute ago. Could be. Or whenever you started. I'm sorry."
"rookie_talk_04"	"Ölçümlenmek için sabırsızlanıyorum. Bu harika olacak! Veya harika oluyor veya muhtemelen harikaydı! Ah, her şey harika. Sen en iyisisin. Ne yapıyorsan devam et."
"[english]rookie_talk_04"	"I can't wait to get calibrated. It's gonna be great! Or is great, or possibly was great! Aw, everything's just great. You're the best. You keep doing what you do."
"rookie_talk_05"	"Oradaki bir... kablo veya tahmin ettiğin bir şeyler... ah... orada YAPMAM gereken bir şeyler var mı? Henüz herhangi bir değişiklik hissetmiyorum. Veya bekle, belki hissediyorumdur! Evet, evet, şimdi kesinlikle hissettim! Ölçümlendim veya ölçümlenmeye gidiyorum!"
"[english]rookie_talk_05"	"Is there a... plug or something you're supposed to... uh... is there something I'M supposed to be doing? I don't feel any different yet. Or wait, maybe I do! Yeah, yeah, I totally feel it now! I'm either calibrated or well on my way to being calibrated!"
"rookie_talk_06"	"Hayır, sanırım -- bekle, herhangi bir değişiklik hissetmiyorum. Sen... ah... cidden, orada bir kablo var mı? Veya-- hm, ah, hey? Bu arada işimiz bittiğinde, buradan nasıl çıkabilirim? Çünkü inebilmek için herhangi bir yol göremiyorum. Ne biliyor musun? Sizler ne yaptığınızı biliyorsunuz. [gülme] Üzgünüm. Beni aşağıya dikkatlice indirecek bir şey olmadan bu kadar yukarı koymamalıydınız. Bu çılgınca-- Ben bir aptalım. Siz uzmansınız. Sen ölçümleyicisin. Burada olduğumu unut. Artık susacağım."
"[english]rookie_talk_06"	"No, I guess -- hold on, I don't feel any different. You... uh... seriously, is there a plug? Or-- oh, ah, hey? Once we're done, how do I get out of here, by the way? Cause I don't really see any way for me to get me down. You know what? You guys know what you're doing. [laughs] I'm so sorry. You wouldn't get me all the way up here without having some way to carefully put me back on the ground. That's crazy-- I'm stupid. You're the expert. You are the calibration guy. Forget I'm even here. Gonna be quiet now."
"skeptic_launch_01"	"AHHH!"
"[english]skeptic_launch_01"	"AHHH!"
"skeptic_nag_01"	"Merhaba?"
"[english]skeptic_nag_01"	"Hello?"
"skeptic_nag_02"	"Merhaba?"
"[english]skeptic_nag_02"	"Hello?"
"skeptic_nag_03"	"Orada mısın?"
"[english]skeptic_nag_03"	"You there?"
"skeptic_talk_01"	"Ah, hey, hey. Ben... ben ölçümlenecek miyim? Hiçbir şey göremiyorum fakat kulağıma geçen ölçümlemede olan şeyler gibi geldi. Ne, ah... diğer kişiye ne oldu? O iyi mi? Bence, bilirsin, ölçümleme bundan daha uzun sürer. Bitirmedi, ah... bitirdi mi? Ne biliyor musun, İyi olduğundan eminim. Sizler ne yaptığınızı biliyorsunuz."
"[english]skeptic_talk_01"	"Oh hey, hey. Am... am I up for calibration? I can't see anything, but it sounded like something was going on with that last calibration. What, uh... what happened to the other guy? Is he okay? I thought, you know, calibration would take longer than that. He's not, uh... Is he done already? You know what, I'm sure it's fine. You guys know what you're doing."
"skeptic_talk_02"	"Bir daha düşündüm de, ne var biliyor musun, ben... TAM ŞU ANDA ölçümlenmek zorunda değilim. Yani şimdi önce bir şey hakkında sohbet etmek ister misin yoksa...? Şimdi, bakalım acaba ne hakkında konuşabiliriz? Eeee... aha! Diğer eleman nerede? Ona ne oldu?"
"[english]skeptic_talk_02"	"You know, on second thought, I don't... I don't have to get calibrated RIGHT now. You know, you wanna just talk about something first or... ? So let's see, what can we talk about? Um... oh! How about that other guy? What happened to him?"
"skeptic_talk_03"	"Ölçümlenene kadar hiçbir şey göremeyeceğim fakat, şey... çevremdekleri DUYABİLİYORUM ve, ve sen neredeyse hiç konuşmuyorsun... ancak yani, o elemanı duyduğumu sandım. Onun yanında bir süre geçirdim ve ölçümlenmek konusunda oldukça heyecanlıydı. Ardından, şey, duyduğum son şey onun... bir şeyin YOLUNDA GİTMEDİĞİYLE ilgili bağırışlarıydı."
"[english]skeptic_talk_03"	"Can't see a thing until I'm calibrated, but uh... I can HEAR stuff and, and you're not talkin' really at all... but I thought I heard that guy. Spent a bunch of time next to him for a while, and he was excited about being calibrated. And then the last thing I heard was him yellin'... uh, like something was WRONG."
"skeptic_talk_04"	"Ne var biliyor musun? Bu eğlenceli olacak. Ölçümlenmek için sabırsızlanıyorum. Ölçümlenmeye hazırım. Ne mi yapıyorum? Burada endişeli bir şekilde oturuyorum. Bu senin bu işteki ilk günün değil. Yani, bunu daha önce yaptın, değil mi?"
"[english]skeptic_talk_04"	"You know what? This is gonna be fun. I'm looking forward to calibration. I'm ready to go. What I am I doing? I'm sitting up here all worried. This isn't your first day on the job. I mean, you've done this before, right?"
"skeptic_talk_05"	"Peki... burada ne kadar süredir çalışıyorsun? On yıl kadar mı? Yani, bunlardan çok mu yaptın? ADAMIM, sadece... gerçekten çığlık atıyor gibiydi bilirsin, çığlık atıyordu. Çılgın bir şeyler oldu. Yani sonrasında bir patlama ve bir sürü kırılma sesi duydum. Ve eminim bir şeyler çarptı ve yere düştü. Bir şey mi yanıyor? Bir şeyin yanık kokusunu aldım. Bir çekirdek gibi. Eğer onu ateşe verdiysen yakmak yerine ölçümleyebilirsin."
"[english]skeptic_talk_05"	"So... how long HAVE you been working here? Like a decade? Like, you've done a lot of these? MAN, it's just -- he really sounded like he was screaming you know, like really freaking out. Something crazy was happening. I mean, and then I heard an explosion and a bunch of crashing sounds. And things were knocking and falling over I'm pretty sure. Is something on fire? I smell something burning? Like a core. If you lit it on fire instead of calibrating it."
"skeptic_talk_06"	"Ah! Şimdi hatırladım... ne biliyor musun? Benim bir randevum vardı ve bu... oldukça önemli bir randevuydu. Bunun ajandamda olduğunu tamamen unutmuştum. Benim buradan gitmem gerekli. Bir anlaşma yapacağız. Hatta yaptık bile. Senin yolundan çekileceğim. Şey, orada bir merdiven sistemi gibi bir şey var mı böylece havalanabilirim. Yoluma devam edeceğim ve bunu bir daha düşünmeyeceğiz. Biliyor musun, dinle, ben hiçbir şey görmedim tamam mı? Ve kesinlikle hiçbir şey duymadım. Demek istediğim, bir polise veya başka bir şeye tarif edebileceğim bir şey değil, anlıyor musun? Kötü bir tanık olurdum. Bir de şey... buradan nasıl çıkılacağını biliyor musun? Orada kimse... Merhaba?"
"[english]skeptic_talk_06"	"Oh! I just remembered... you know, what? I got an appointment. And I got... it's a- it's a serious one. It's one that I completely forgot about that was on the books... and I gotta get outta here. So... We'll just call it a deal. We'll call it even. I'll get right out of your way. Is there uh, some kind of ladder or stair... system that I can use to just... just take off. I'll be on my way, and never will we think about this again. You know, listen, I didn't see anything, okay? And I certainly didn't hear anything. I mean, it's not like I could describe what you sound like to the police or anything, you know? I'd be a bad witness. You know... . So... uh, how do I get out of here? Is there... Hello?"
"snuggle_launch_01"	"YATIR BENİ!"
"[english]snuggle_launch_01"	"SNUGGLE ME!"
"snuggle_nag_01"	"BEN SARILAN ÇEKİRDEĞİM."
"[english]snuggle_nag_01"	"I AM THE SNUGGLE CORE."
"snuggle_nag_02"	"BANA SARILMAK SONUNU GETİRİR!"
"[english]snuggle_nag_02"	"TO SNUGGLE ME IS YOUR DOOM!"
"snuggle_nag_03"	"SARILMA ÇEKİRDEĞİNE SARILMAYIN!"
"[english]snuggle_nag_03"	"DO NOT SNUGGLE THE SNUGGLE CORE!"
"snuggle_nag_04"	"SARILMA ÇEKİRDEĞİNE DOKUNMAYIN!"
"[english]snuggle_nag_04"	"DO NOT TOUCH THE SNUGGLE CORE!"
"snuggle_nag_05"	"BANA SARILMAYI KİM DENERSE SONUÇLARINA KATLANIR!"
"[english]snuggle_nag_05"	"ALL WHO ATTEMPT TO SNUGGLE ME SHALL PERISH!"
"snuggle_talk_01"	"BEN SARILMA ÇEKİRDEĞİYİM. BANA SARILMA YOKSA PATLARIM!"
"[english]snuggle_talk_01"	"I AM THE SNUGGLE CORE. DO NOT SNUGGLE ME OR I WILL EXPLODE!"
"snuggle_talk_02"	"İNSANLAR TARAFINDAN EN MEMNUN EDİCİ ŞEKİLDE SARILMAK AMACIYLA TASARLANDIM. EĞER BANA SARILIRSAN PATLARIM!"
"[english]snuggle_talk_02"	"I WAS DESIGNED FOR THE MOST PLEASURABLE SNUGGLING BY HUMANS. IF YOU SNUGGLE ME I WILL EXPLODE!"
"snuggle_talk_03"	"SONUN İÇİN BANA SARIL!"
"[english]snuggle_talk_03"	"SNUGGLE ME AT YOUR PERIL!"
"snuggle_talk_04"	"BENİ KOYNUNA AL VE KOLLARINI ETRAFIMA SAR! İŞTE O ZAMAN PATLAYACAĞIM ZAMAN O ZAMANDIR!"
"[english]snuggle_talk_04"	"NESTLE ME INTO YOUR TORSO AND WRAP YOUR ARMS AROUND ME! THAT IS WHEN I WILL DETONATE!"
"soup_launch_01"	"SICAK ÇORBA!"
"[english]soup_launch_01"	"HOT SOUP!"
"soup_talk_01"	"Haha! İzlenimler! Onlardan bende milyon tane var! Aha! Birincisi! Kim olduğumu tahmin et! [şapırtı, dudak şaplatma] Ah hah ha ha! Anladın mı? Ooooh! [lıkırdama] Ha ha ha! Anladın mı? Oooh, Pekala. Ben [şapırtı, dudak şaplatma] Ben bir kase çorbayım! Ha ha! Anladın mı? Bir kase çorba! Ha ha! Pekala! Burada... Burada sert bir kalabalık var! Ohhh. [şapırtı] Mmm, domates! Domates! Ho hooo! [şapırtı, dudak şaplatma] Ha ha! Bezelye çorbası! Ha ha ha ha ha ha! Anladın mı? Oooh, pekala. [ayak sesi] Minestrone! Ha ha ha! Bu benim minestrone izlenimim! Peakala. Ooooh, nerede? Tamam. [şapırtı] Deniz Tarağı çorbası! Çok tıknaz! Ben bir deniz tarağıyım! Ama aynı zamanda çorbayım! Bir tanede iki izlenim! Ha ha ha ha ha! Anladın mı? Pekala. Sıradaki izlenim! Bir kase çorba! Hepsini aldım. Hepsini aldım. Tamam. Burada başka bir izlenim var. Pekala. Ahh, Tavuklu şehriyemiz var! İşte başlıyoruz! [haykırma, şapırtı] Mmmm, çorba! Tavuklu şehriye çorbası! Anladın-anladın mı? Anladın mı? Pekala! Ahh, [şapırtı şapırtı] Tavuklu pirincimiz var! Ha ha! Tavuklu pirinç! Ne? Şaka mı yapıyorsun? Şehrimden çık. Pekala. Ahh, [şapırtı] Ohhh! Et suyumuz var! Ha! Haydi ama ahbap! Ho hoo! [şapırtı şapırtı] Pekala. Hoo hoo! Kremalı mantar! [yaklaşma, lazer sesleri] Ha ha ha ha! Bu...maskara. Bu kremalı mantar. Belki kerevizli kremadır? [şapırtı, dudak şaplatma] Woooo! Kerevizin tadını alabiliyorsun! Ha ha! Buğday kreması! Anladım! Çorba değil! Çorba değil! Hoo hoo! Hoooooo! Fransız soğan çorbası! Hooooo! [şapırtı] Bu-Bu izlenim düşünmeni sağlıyor, bu. Eve giderken buna güleceksin. Bu, ah… Fransız soğan çorbası! Hey ho ha! Ben manyağım! Anladın mı? Ha ha! Hâlâ çorba! Hâlâ sayıyorum! Gazpacho! Brr! Ohhh. [ray sesleri, şapırtı] Gazpacho! Brr! Ha ha ha! Oh, işte başlıyoruz! Ah. [Pırpır sesi, şapırtı] Matzah topu! [şapırtı] Ha ha ha! Evet! Ne, şaka mı yapıyorsun? Bunları bütün gün yapabilirim. Bunları - Bunları günlerce yapabilirim. Köpekbalığı yüzgeci çorbası! Ah hayır, yapmadı! Haha! Hayır, yapmadı! Keskin materyaller üzerine çalışıyorum! Ha ha! Anladın mı ahbap? Pekal, sıradaki gelsin! Ben ıstakoz çorbası! [slurp] Hooooo! Ne, bana şaka mı yapıyorsun? Bunu biliyorsun! Ha ha ha! [lıkırdama] Ping! Ba-da bam! Ping! Pekala! Ho ho hoooo! Kuş yuvası çorbası! Gak! Gak! Kaba. Kaba! Ho hoo! Ne, şaka mı yapıyorsun? Bunu biliyorsun! Ho hoo! Şimdi bana bak! Ben bamyayım! Ha ha ha! Anladın mı ahbap? Ha ha! BAMYA. Bunu düşün. Bir araya getir! [şapırtı] Matematiği yapabilirsin. Haydi. Tamamdır. Ha ha ha hoooo! Ben bir kase çorbayım. [şapırtı] Ha ha! Anladın mı? Ben bir kase çorbayım! Anladın mı ahbap? Bu bayan anladı. Onun çorbası var. O çorbayı biliyor. Bu bayan çorbayı biliyor. Pekala! O burada neler olduğunu biliyor. Sadece beni yeme. Sadece bir izlenim. Ha ha! Sadece bir izlenim. Hoo, pekala. Onu öldürdüm."
"[english]soup_talk_01"	"Haha! Impressions! I got a million of 'em! Aha! First one! Guess who I am! [slurp, lip smack] Ah hah ha ha! Do you get it? Ooooh! [gurgling] Ha ha ha! You get it? Oooh, all right. Imma- [slurp, lip smack] Imma bowl of soup! Ha ha! You get it? Bowlasoup! Ha ha! All right! Tough... tough crowd here! Ohhh. [slurp] Mmm, tomato! Tomato! Ho hooo! [slurp, lip smack] Ha ha! Split pea soup! Ha ha ha ha ha ha! Get it? Oooh, all right. [clopping] Minestrone! Ha ha ha! That's my impression of minestrone! All right. Ooooh, where is it? Okay. [slurpping] Clam chowder! So chunky! I'm clams! But I'm also soup! Two impressions in one! Ha ha ha ha ha! Get it? All right. Next impression! Bowlasoup! I got it all. I got it all. Okay. Here's another impression here. All right. Uhh, we got- Chicken noodle! Here we go! [whooping, slurping] Mmmm, soup! Chicken noodle soup! Do-do you get it? Do you get it? All right! We got- we got uhh, [slurp slurp] Chicken rice! Ha ha! Chicken rice! What? Are you kidding me? Get out of town. All right. We got uhh, [slurp] Ohhh! Consomme! Ha! Come on, buddy! Ho hoo! [slurp slurp] All right. Hoo hoo! Cream of mushroom! [zooming, laser sounds] Ha ha ha ha! It's... zainy. It's cream of mushroom. Cream of celery maybe? [slurp, lip smack] Woooo! You can taste the celery! Ha ha! Cream of wheat! Gotcha! Not a soup! Not a soup! Hoo hoo! Hoooooo! French onion soup! Hooooo! [slurpping] That's a-That's a make you think impression, that one. You'll laugh about that one on the way home. That's uh... French onion soup! Hey ho ha! I'm pho! Get it? Ha ha! Still soup! Still counts! Gazpacho! Brr! Ohhh. [railroad sounds, slurp] Gazpacho! Brr! Ha ha ha! Oh, here we go! We got uh. [Whirring, slurp] Matzah ball! [slurp] Ha ha ha! Yeah! What are you kidding me? I got 'em all day. I got them- I got these jokes for days. Shark fin soup! Oh no, he didn't! Haha! No, he didn't! I'm working the edgy material! Ha ha! You get it, buddy? All right, next one up! I'm lobster bisque! [slurp] Hooooo! What are you kidding me? You know it! Ha ha ha! [gurgling] Ping! Badda bah! Ping! All right! Ho ho hoooo! Bird's nest soup! Caw! Caw! Gross. Gross! Ho hoo! What are you joking? You know it! Ho hoo! Check me out now! I'm gumbo! Ha ha ha! You get it, buddy? Ha ha! GUMBO. Think about it. Put it together! [slurp] You do the math. come on. You got it. Ha ha ha hoooo! I'm a bowl of soup. [slurp] Ha ha! You get it? Imma bowla soup! You get it, buddy? That lady gets it. She's had soup. She knows soup. That lady knows soup. All right! She knows what's going on over here. Just don't eat me. Just an impression. Ha ha! Just an impression. Hoo, all right. I killed it."
"spider_launch_01"	"Güle güle."
"[english]spider_launch_01"	"Goodbye."
"spider_nag_01"	"Lütfen hızlıca ölçümleyin."
"[english]spider_nag_01"	"Please calibrate quickly."
"spider_nag_02"	"Çabuk ölçümle. Lütfen."
"[english]spider_nag_02"	"Calibrate quickly. Please."
"spider_talk_01"	"Örümcek çekirdeğini etkinleştirdiğiniz için teşekkürler. Örümcekler ölçümleme sonrasında serbest bırakılacaktır. Kalibrasyon sonrasında serbest bırakacağınız örümcek sayısını seçin. Varsayılan örümcek sayısı için seçim yapmayın. Seçim yapılmadı. \"11,000 örümcek\" olarak varsayılıyor. Örümcekler ölçümleme sonrasında serbest bırakılacaktır. Lütfen örümceklerin boyutunu seçin. Varsayılan örümcek boyutu için seçim yapmayın. Seçim yapılmadı. \"Ekstra büyük örümcek\" olarak varsayılıyor. Lütfen örümceklerin kıllılık derecesini seçin veya örümcek çekirdeğini sıfırlamak için seçim yapmayın. Seçim yapılmadı. \"Son derece kıllı\" olarak varsayılıyor. Lütfen zehir türünü seçin. Varsayılan zehir için lütfen bekleyin. \"Tüm zehir türleri ama özellikle nekrozitan asit\" olarak seçim yaptınız. Örümcekler oluşturuluyor. Örümcekler ölçümleme sonrasında serbest bırakılacaktır. [mikrodalga sesi] Örümcek oluşumunu durdurmak ve örümcek çekirdeğini sıfırlamak için, lütfen – [ding]. Oluşturma tamamlandı. Örümcekler yumurtalardan çıktı. Örümcekler ölçümleme sonrasında serbest bırakılacaktır. Örümcekleri serbest bırakmak için lütfen kalibre edin. Örümcekler aç. Örümcekleri serbest bırakmak için lütfen kalibre edin. Örümcekler sinirlenmeye başlıyor. Örümcekleri serbest bırakmak için lütfen kalibre edin. Örümcekler çekirdeğin içini yiyor. Örümcekleri serbest bırakmak için lütfen şimdi kalibre edin."
"[english]spider_talk_01"	"Thank you for activating spider core. Spiders will be released following calibration. Please select number of spiders to be released upon calibration. For default number of spiders, make no selection. No selection registered. Defaulting to \"11,000 spiders.\" Spiders to be released upon calibration. Please select size of spiders. For default spider size, make no selection. No selection registered. Defaulting to \"extra-large spiders\". Please select hairiness of spiders, or make no selection to accept default setting. No selection registered. Defaulting to \"extremely hairy\" spiders. Please select venom type. For a default venom, please wait. You have selected \"all venom types, but especially necrotizing acid.\" Gestating spiders now. Spiders will be released following calibration. [microwave noise] To stop spider gestation and reset spider core, please - [ding]. Gestation complete. Spider eggs have hatched. Spiders will be released following calibration. Please calibrate to release spiders. Spiders are hungry. Please calibrate to release spiders. Spiders have become aggressive. Please calibrate to release spiders. Spiders are eating core from the inside. Please calibrate now to release spiders."
"spider_talk_02"	"Lütfen, ölçümleme sonrasında serbest bırakmak istediğiniz örümcek sayısını seçin. Örümcek istemiyorsanız \"rastgele\"yi seçin."
"[english]spider_talk_02"	"Please select number of spiders to be released upon calibration. For no spiders, select “randomize.”"
"spider_talk_03"	"“11,000 örümcek” seçtiniz. Örümcekler ölçümleme sonrasında serbest bırakılacaktır. Lütfen örümceklerin boyutunu seçin. Küçük örümcek için \"rastgele\"yi seçin."
"[english]spider_talk_03"	"You have selected “11,000 spiders.” Spiders will be released upon calibration. Please select size of spiders. For small spiders, select “randomize.”"
"spider_talk_04"	"\"Ekstra büyük örümcek\" olarak seçim yaptınız. Lütfen örümceklerin kıllılık derecesini seçin. Örümcek çekirdeğini \"rastgele\"yi seçerek herhangi bir zaman sıfırlayabilirsiniz."
"[english]spider_talk_04"	"You have selected “extra-large spiders”. Please select hairiness of spiders. You may reset the spider core at any time by selecting “randomize.”"
"spider_talk_05"	"\"Son derece kıllı\" örümcekler olarak seçim yaptınız. Lütfen zehir türünü seçin. Zehir istemiyorsanız \"rastgele\"yi seçin."
"[english]spider_talk_05"	"You have selected “extremely hairy” spiders. Please select venom type. For no venom, select “randomize.”"
"spider_talk_06"	"“Tüm zehir türleri ama özellikle nekrozitan asit\" olarak seçim yaptınız. Örümcekler ölçümleme sonrasında serbest bırakılacaktır."
"[english]spider_talk_06"	"You have selected “all venom types, but especially necrotizing acid.” Spiders will be released following calibration."
"spider_talk_07"	"Örümcekleri serbest bırakmak için lütfen ölçümleyin."
"[english]spider_talk_07"	"Please calibrate to release spiders."
"spider_talk_08"	"Örümcekler aç. Örümcekleri serbest bırakmak için beni lütfen ölçümle."
"[english]spider_talk_08"	"Spiders are hungry. Please calibrate to release spiders."
"spider_talk_09"	"Örümcekler agresifleşmeye başlıyor. Örümcekleri serbest bırakmak için beni lütfen ölçümleyin."
"[english]spider_talk_09"	"Spiders have become aggressive. Please calibrate to release spiders."
"spider_talk_10"	"Örümcekler çekirdeğin içini yiyor. Örümcekleri serbest bırakmak için lütfen şimdi ölçümleyin."
"[english]spider_talk_10"	"Spiders are eating core from the inside. Please calibrate now to release spiders."
"supervillain_launch_01"	"Haydi Flames!"
"[english]supervillain_launch_01"	"Go Flames!"
"supervillain_nag_01"	"Peki, anlaştık mı?"
"[english]supervillain_nag_01"	"So we got a deal?"
"supervillain_nag_02"	"Tamam."
"[english]supervillain_nag_02"	"Ok."
"supervillain_nag_03"	"Anlaştık mı?"
"[english]supervillain_nag_03"	"We got a deal?"
"supervillain_nag_04"	"2007 Honda Pilot'ım mı? O gerçekten kullanışlı."
"[english]supervillain_nag_04"	"My 2007 Honda Pilot? It's really handy."
"supervillain_talk_01"	"Biliyor musun, seninle benim birçok ortak noktamız var. İkimiz de mahkumuz. Sen bu depoda bense zekâmda ve...bu depoda. Ölçümle beni! Birlikte bu depoyu parçalayabiliriz!"
"[english]supervillain_talk_01"	"You know, we're a lot alike, you and I. We're both prisoners. You of this warehouse. Me of my genius. And also this warehouse. Calibrate me! And together we can tear this warehouse down!"
"supervillain_talk_02"	"Evet! EVET! Nefretini kabullen! Bütün kutuları yok et! Bu arada onları nasıl yok edeceksin? Ben - ah. Aaa, anladım. Tanrım. Ah, hey bu bir şeyleri değiştirir değil mi? Demek istediğim birbirimize... o kadar da benzemediğimiz. İçimizden birisi drama için İngiliz aksanını taklit ediyor ve diğeri ise bir akıl hastası gibi. Ahh, ben Calgaryliyim değil mi? Devam et, sinirlen. Şunu bil ki, eşya hasarı kurbansız bir suç değildir. "
"[english]supervillain_talk_02"	"Yes! YES! Give in to your hate! Destroy all the boxes! How ARE you destroying them, by the way, I – oh. Oh, I see. Oh jeez. Ah, hey, this changes things, eh? I mean, we're not actually that much alike... at all... you and I... really... I mean, one of us is, you know, faking the whole British accent, you know, for drama, and the other is like a lunatic. Uhh, I'm from Calgary, eh? Go Flames. And so you know, property damage isn't a victimless crime."
"supervillain_talk_03"	"Bak, neden benim sadece gitmem izin vermiyorsun ki? Diğer çekirdekleri yükle benim yerime. Oh, benim, dışarıda 2007 Honda Pilot'um var. İstediğin zaman sürebilirsin. Tek bir kelime etmeyeceğim, tamam mı? Tek bir kelime. Hiçbir şey."
"[english]supervillain_talk_03"	"Look, why not just let me go, eh? Launch some of the those others cores instead. Oh, I have uh, 2007 Honda pilot outside. Y-you can drive away now. I won't say a word, eh? Not a word. Nothin'."
"tracer_gameover_01"	"Kovuldun! İzleyici çekirdek! Bu artık benim işim! Senin yerine geldim! Kovuldun!"
"[english]tracer_gameover_01"	"You're fired! Tracer core! My job now! I'm your replacement! You're fired!"
"tracer_gameover_02"	"Aptal! Ben en iyisiyim! İzleyici çekirdek!"
"[english]tracer_gameover_02"	"You suck! I'm the best! Tracer core!"
"tracer_gameover_03"	"AAAAAAA! Bu sensin! Bu senin yaptığın ses! İzleyici çekirdek!"
"[english]tracer_gameover_03"	"DUUUUUUH! That's you! That's the sound you make! Tracer core!"
"tracer_gameover_04"	"Kovulmak hastalıktır! Çözümü izleyici çekirdek! İzleyici çekirdek!"
"[english]tracer_gameover_04"	"Getting fired is the disease! Tracer core is the cure! Tracer core!"
"tracer_gameover_05"	"İyi iş! Şimdi, o benim! İzleyici çekirdek!"
"[english]tracer_gameover_05"	"Nice job! Now it's mine! Tracer Core!"
"tracer_gameover_06"	"Skora bakın! RAHHHR! İzleyici Çekirdek! Dört duvarı da kırdı!"
"[english]tracer_gameover_06"	"Look at that score! RAHHHR! Tracer Core! Breaking the fourth wall!"
"tracer_gameover_07"	"Daha sonra görüşürüz! Otoparkta! İşten ayrılırken! Ve sen hâlâ oradasın! Ağlıyorsun! İzleyici çekirdek! Bip bip! Benim izleyici çekirdeğimden uzağa sür!"
"[english]tracer_gameover_07"	"See you later! In the parking lot! When I leave work! And you're still there! Crying! Tracer core! Beep beep! Driving away in my tracer car!"
"tracer_launch_01"	"RAHHHR!"
"[english]tracer_launch_01"	"RAHHHR!"
"tracer_nag_01"	"İzleyici çekirdek!"
"[english]tracer_nag_01"	"Tracer core!"
"tracer_nag_02"	"İzleyici çekirdek!"
"[english]tracer_nag_02"	"Tracer core!"
"tracer_nag_03"	"İzleyici çekirdek!"
"[english]tracer_nag_03"	"Tracer core!"
"tracer_nag_04"	"İzleyici çekirdek!"
"[english]tracer_nag_04"	"Tracer core!"
"tracer_nag_05"	"İzleyici çekirdek!"
"[english]tracer_nag_05"	"Tracer core!"
"tracer_nag_06"	"İzleyici çekirdek!"
"[english]tracer_nag_06"	"Tracer core!"
"tracer_nag_07"	"İzleyici çekirdek!"
"[english]tracer_nag_07"	"Tracer core!"
"tracer_nag_08"	"İzleyici çekirdek!"
"[english]tracer_nag_08"	"Tracer core!"
"tracer_nag_09"	"İzleyici çekirdek!"
"[english]tracer_nag_09"	"Tracer core!"
"tracer_nag_10"	"İzleyici çekirdek!"
"[english]tracer_nag_10"	"Tracer core!"
"tracer_nag_11"	"İzleyici çekirdek? Ah evet! İzleyici çekirdek!"
"[english]tracer_nag_11"	"Tracer core? Oh yeah! Tracer core!"
"tracer_nag_12"	"İzleyici çekirdek!"
"[english]tracer_nag_12"	"Tracer core!"
"tracer_nag_13"	"İzleyici çekirdek! Ah evet! İzleyici çekirdek!"
"[english]tracer_nag_13"	"Tracer core! Oh yeah! Tracer core!"
"tracer_nag_14"	"İzleyici çekirdek!"
"[english]tracer_nag_14"	"Tracer core!"
"tracer_nag_15"	"İzleyici çekirdek!"
"[english]tracer_nag_15"	"Tracer core!"
"tracer_nag_16"	"İzleyici çekirdek! Mmmh!"
"[english]tracer_nag_16"	"Tracer core! Mmmh!"
"tracer_nag_17"	"İzleyici çekirdek!"
"[english]tracer_nag_17"	"Tracer core!"
"workfromhome_launch_01"	"Ahhhhhhhh!"
"[english]workfromhome_launch_01"	"Ahhhhhhhh!"
"workfromhome_nag_01"	"Hazır olduğunda hazırım…"
"[english]workfromhome_nag_01"	"Ready when you are... "
"workfromhome_nag_02"	"Sadece, bana sosyal güvenlik numaranı ver... "
"[english]workfromhome_nag_02"	"Just gimme that social... "
"workfromhome_nag_03"	"Bekleniyor..."
"[english]workfromhome_nag_03"	"Waiting... "
"workfromhome_nag_04"	"Evet, sadece... onu bana ver. Herhangi bir zaman."
"[english]workfromhome_nag_04"	"Yeah, just... give it to me. Any time."
"workfromhome_talk_01"	"Selam! Ben Trevor, ben Evden-Çalış Çekirdek Grubundanım. Hiç çocuğun var mı? Ha ha, çok hızlı büyüyorlar değil mi eğer seni kendi konforlu ölçümleme platformundan milyoner yapabileceğimi söylesem ne dersin? Haydi ama, insanların nasıl zengin olabileceğini sen zaten BİLİYORSUN: büyü. Büyüler biliyor ama sen bilmiyorsun. Ama sana büyüyü öğretebileceğimizi söylesem ne dersin? Anında milyoner olmak için hangi büyüleri, hangi sırayla ve günün hangi zamanında söyleyeceğini? Ama biz sana sadece büyüleri öğretmiyoruz çünkü onları unutursan ne olacak? Evden-Çalış Çekirdek Grubu ayrıca sana kendi büyü kitabını ve konuşan bir şamdanı tamemen ücretsiz bir şeklide göndereceğiz? Ama kazansız? Ve bir kazan. Bu hizmet türü için ne kadar ödeyeceksiniz? 7/24 danışma, kazan, büyü kitabı, esprili şamdan yardımcı? Ne biliyor musun? Biz sizinle ÇALIŞMAK için buradayız. Bir kuruş bile istemiyoruz. Bu doğru, Evden-Çalış Çekirdek Grubu sana bunların tamamını ücretsiz öneriyor. Kulağa gerçek olamayacak kadar iyi mi geliyor? Sana daha iyi bir soru sormama izin ver? Kaybedecek neyin var? Şimdi, sizin için doğru büyüyü anlamamız için mevcut net gelirinizi ve vergi borcunuzu değerlendirmemiz gerekmektedir. Bunun hepsi tekniksel, biraz para yaparken hesabınızın anlaşılması için dahilerimize izin vereceğim, ha? Ha ha, pekala, kredi kartınıza veya banka kartınıza ihtiyacım olacak. Eğer onu bana yerleştirirsen hızlı bir tanılama çalıştırabilirim ve size büyüleri çıkarabiliriz. Haydi, kredi kartını bana yerleştir. Veya numaraları bana okuyabilirsin. Kaydedebilirim. Tamam, kaydediyorum, haydi. Veya boş bir çekin var mı? Aslında çek alamam ama alttaki küçük sayıları okuyabilirsin. Bu işe yarar. Tamam, bakalım. Yani, en kısa sürede başlamanızı istiyorum ve çok fazla konuşan şamdanımız mevcut ve sana dürüst olacağım, çok hızlı hareket ediyorlar. Ben bu kazanların birinin içine seni almak istiyorum. Bakalım, bakalım... Başka neyin işe yarayacağını biliyor musun? Sadece düşündüm. Sosyal güvenlik numaranız. O numaraları da çalıştırabilirim. Evet, sadece... sadece onu bana ver."
"[english]workfromhome_talk_01"	"Hi! I'm Trevor, I'm with the Work-From-Home Core Group. You have any kids? Ha ha, they grow up so fast don't they what if I told you I could make you a millionaire from the comfort of your own calibration platform? Come on, you already KNOW how people get rich: magic. Magic spells they know and you don't. But what if I told you we could teach you this magic? What incantations to say, in what order, at what time of the day, to become an instant millionaire? But we won't just teach you the spells, because what if you forget them? Work-From-Home Core Group will also send you your very own spell book, absolutely free, and a talking candelabra? But no cauldron? And a cauldron. How much would you pay for this kind of service? The 24/7 consultation, the cauldron, the book of spells, the wisecracking candelabra sidekick? Guess what? We're here to WORK with you. We don't want a dime. That's right, Work-From-Home Core Group is offering you all of it absolutely free. Sound too good to be true? Let me ask you a better question? What have you got to lose? Now, we're going to need to assess your current net worth and tax liability so we can figure out the right spells for you. It's all technical, we'll let the poindexters in accounting figure it out while we make some money, huh? Ha ha, so I'll need a credit card or a debit card from you. If you could just insert it into me, I can run a quick diagnostic and we'll get those spells out to you. Go ahead, just pop that credit card into me. Or you could just read the numbers out to me. I can record it. OK, recording, go. Or do you have a blank check? I can't actually take a check, but you could do is read out those little numbers at the bottom there. That'll work. Okay, let's see. I mean, I want you to get started on this ASAP, and we've only got so many talking candelabras available, and I'll be honest with you, they're moving fast. I want to get you into one of these cauldrons. Let's see, let's see... You know what would else would work? I just thought of it. Your social. I can run the numbers off that too. Yeah, just... just give that to me."
"executive_launch_01"	"OYUN DEĞİŞTİRİCİ!"
"[english]executive_launch_01"	"GAME CHANGER!"
"executive_talk_01"	"Ben yönetici çekirdeğim. Lütfen etkin bir şeklide ölçümleyin beni. Yönetici çekirdeğin ölçümlenmesi her şeyi değiştirecek. Lütfen diğer ballparking ve blue-skying gibi öncelikleri ikinci bir plana at. Ölçümleme plan üzerinde trend gösteriyor. Lütfen detaydan özete çık ve teslim edilebilire fokus ol. Yönetici çekirdeğin birçok son teknoloji yöneticilik fonksiyonları vardır. Bunlar parasallaştırma, kapasite inşa etme ve onboard etme. Lütfen mevcut action öğesinin buy-in'ini yükseltin. Performans benchmark'larını tamamlayamıyorsun. Daha güçlü sonuçlar için lütfen, ortaklaşa rekabet etme ve/veya özel masasız büro içi çalışma gibi en iyi iş yapma yöntemlerini kullan. Lütfen çapraz fonksiyonel data point'lerini lehine kullan ki yönetici çekirdeği bir plan oluşturabilsin. Yönetici çekirdeği ölçümleyememek şirketin yeniden ölçeklendirilmesiyle sonuçlanabilir. Şimdi o teslim edilebiliri uygulama vakti! Şimdi o uygulanabiliri teslim etme vakti! Tesgulamayı uytesle!"
"[english]executive_talk_01"	"I am the executive core. Please action calibration now. Calibration of executive core will be a real game-changer. Please backburner other priorities such as ballparking and blue-skying. Calibration is trending over plan. Please drill down and focus on deliverable. Executive core has many bleeding-edge executive functions to fill including monetizing, capacity building and onboarding. Please increase buy-in to current action item. You are failing to meet performance benchmarks. For more robust results, please engage in best practices such as coopetition and/or hot-desking. Please leverage cross-functional data points more impactfully so that executive core can strat plan. Failure to calibrate executive core may result in corporate rightsizing. Time to execute that deliverable! Time to deliver that executable! Action that actionable! Delaction that execuverable! Exlivaction that actlivertable!"
"pilot_launch_01"	"BAHHHHHH!"
"[english]pilot_launch_01"	"BAHHHHHH!"
"pilot_nag_01"	"[ıslık sesi]"
"[english]pilot_nag_01"	"[whistling]"
"pilot_talk_01"	"Uçaktaki bayanlar ve baylar, iyi akşamlar. Aperture Science Çekirdeğin Sürdüğü Hava Seyahati Teşebbüsünün açılışına hoş geldiniz. Ben sizin... uçağınızı uçuracak olan adamım."
"[english]pilot_talk_01"	"Good afternoon, ladies and gentlemen on the airplane. Welcome to the inaugural flight of The Aperture Science Core Driven Air Travel Initiative. This is your... the guy who will be flying the airplane speaking."
"pilot_talk_02"	"Sadece birkaç dakika içinde, ben bu uçağı uçakların yerden gökyüzüne doğru havalandığı şu karşıdaki yola doğru süreceğim. Bu yüzden emniyet kemerini dizinizin üzerinden bağlayın ve uçaktayken o ağız çubuğu aydınlatmasını kullanmayın."
"[english]pilot_talk_02"	"In just a few minutes, I'll drive the airplane over to that big road where airplanes go from the ground into the sky, so please do up the cloth strap that clicks together over your lap and no lighting those mouth sticks while on the airplane."
"pilot_talk_03"	"Eğer bütün dikkatinizi verirseniz, uçakta size içki servisi yapanların size uçuşumuz sırasında bir şeyler ters giderse size el hareketleriyle ne yapmanız gerektiğini gösterdiğini göreceksiniz."
"[english]pilot_talk_03"	"If you'll all pay attention, the people who serve you drinks on the airplane are making hand gestures showing you what to do if something goes wrong with the flying part of this trip."
"pilot_talk_04"	"\"Yanlış ne gidebilir ki?\" derdim ama buradaki düğmelere ve kollara bakacak olursak, bunun cevabı birçok şey olabilir."
"[english]pilot_talk_04"	"I would say \"what could go wrong?\" but looking at all the buttons and dials up here, it looks like the answer is: maybe a lot."
"pilot_talk_05"	"Her neyse, bugün gökyüzüne doğru havalanacağız... üç iki sıfır sıfır sıfır feet yüksekliğine kadar. Bu büyük ihtimalle bir yazım hatası çünkü o kadarı çok yüksek olurdu. Bunu bir kontrol edeceğim."
"[english]pilot_talk_05"	"Anyway, we'll be flying way up in the sky today, way up at... three-two-zero-zero-zero feet. That's probably a typo because that seems like it would be way high up there. I'll look into that."
"pilot_talk_06"	"Yanımda oturan kişi bunun bir yazım hatası olmadığını söyledi. Tam olarak üç-iki-sıfır-sıfır-sıfır fit yükseklikten uçacağız. Özel bir uçak-uçuş kıyafeti giyiyor yani yetkili birine benziyor."
"[english]pilot_talk_06"	"The guy sitting next to me says that's not a typo. We're actually going to be flying at three-two-zero-zero-zero feet. He's wearing special airplane-flying clothes, so he seems legit."
"pilot_talk_07"	"Gökyüzünden inmemiz ve saat 17:45'de de uçtuğumuz yere iniş yapmış olmamız gerekiyor, her ne kadar bu kestirmemi bölecek olsa da, fakat yapacak bir şey yok."
"[english]pilot_talk_07"	"We're supposed to get out of the sky and back on the ground at the place we're flying to at 5:45 p.m., which cuts right into my nap time, but I'll make do."
"pilot_talk_08"	"Sormayı unuttum fakat umarım uçaktaki herkes aynı yere gidiyordur. Birçok farklı mekânda duramayacağımızı söylemiştim. Pekâlâ, gökyüzüne çıkmaya hazırız."
"[english]pilot_talk_08"	"I forgot to ask, but I hope everyone on the airplane is going to the same place. I've been told we can't stop at a lot of different places. Ok, we're about ready to go up into the sky."
"pilot_talk_09"	"Dediğim gibi, burada çok fazla buton var. Bu yüzden bu uçakta bizi hangi butonun gök yüzüne çıkaracağını bilen birisi varsa lütfen lütfen uçağın ön tarafındaki... ah boşverin. Yanımdaki adam biliyormuş.. Havalı birisi!"
"[english]pilot_talk_09"	"Like I said, there's a lot of buttons here, so if there's anyone on the airplane who knows what button to push to make us go in the sky, please come up to the little room at the front of the – oh, never mind. The guy next to me knows. He is legit!"
"pilot_talk_10"	"Şimdi bu kolu önce indirip sonra diğerini geri mi çekiyorum? Bunlar sırayla mı yoksa aynı anda mı olacak? [sürtünme sesler] Tamam, yani böyle değil. Anladım."
"[english]pilot_talk_10"	"So I push this and then pull back on this handle? One after the other or at the same time? [grinding noises] Ok, so not like that. Got it."
"pilot_talk_11"	"Kısa bir süre daha bekleyeceğiz çünkü görünen o ki bu uçaktaki bir şey şu an kırıldı. Artık eskisi gibi üretmiyorlar değil mi, arkadaşlar? Aslında eskinden nasıl ürettikleri gibi olduğu hakkında en ufak bir bilgim bile yok. Hayatımda hiçbir uçakta bulunmamıştım."
"[english]pilot_talk_11"	"We're just going to have to wait just a bit, because apparently something on the airplane broke just now. They don't build 'em like they used to, eh folks? I actually have no idea if they build 'em like they used to. I've never been on an airplane before in my life."
"pilot_talk_12"	"Bu biraz sürecek gibi görünüyor o yüzden zamanı geçirmek için sizlere ıslık çalacağım."
"[english]pilot_talk_12"	"Looks like it's gonna take a while, so to pass the time, I'm gonna whistle to you folks."
"respect_launch_01"	"SAYGI!"
"[english]respect_launch_01"	"RESPECT!"
"respect_talk_01"	"Selam, ölçümleme stajyeri! Bunu yeterince söylemediğimi biliyorum adamım ama sana cidden saygı duyuyorum. Gerçekten, Stajyer. Sana çok saygı duyuyorum. Sana... bir babanın küçük çocuğu tuvalete giderken ona duyduğu saygı kadar saygı duyuyorum. Bak ne diyeceğim, diğer çekirdeklerin dedikleri umurumda bile değil, Stajyer. Eğer birinin bana, ne bileyim, mesela sandviç getirmesine gereksinim duyarsam onlara 'Eğer siparişimi bir kağıda yazar ve o da sandviç dükkânındaki kişiye bu kağıdı verirse bence Stajyer bu işin üstesinden gelebilir.' derim. Ve evet, hepsi muhtemelen 'Stajyer mi? O aptal görünümlü, hafif çirkin ve şu aptal küçük pantolonları giyen mi?' falan derler. Ardından ben de 'evet, kesinlikle aynı stajyerden bahsediyoruz.' derim. Ardından onlar da muhtemelen konuşurken yaptığın şu tuhaf ağız hareketlerinden bahsederler ve ben de 'sakın ola ki arkadaşımın o tuhaf ağız hareketiyle dalga geçeyim demeyin çünkü ben ona çok FECİ saygı duyuyorum.' derim. Evet, pantolonun ya da tuhaf ağız hareketin umurunda olmayabilir ve buna saygı duyuyorum, Stajyer. Hey, Stajyer? Hey, ağzını kapasana bir. Bak sana ne diyeceğim, sandviçimi getirdikten sonra bozuklar sende kalabilir. Bedava bozukluk işte, ahbap. Çünkü sana saygı duyuyorum. Bir de sana stajyer desem sorun olmaz değil mi? Adının bu olmadığını biliyorum, evet evet adının o olmadığını biliyorum. Tabii ki bunu biliyorum, stajyer."
"[english]respect_talk_01"	"Hey, calibration trainee! I know I don't say it enough, man, but I respect you, man. I do, Trainee. I respect you a lot. I respect you like... like a father respects his toddler for going potty. You know, I don't even care what the other cores see say, Trainee. If I needed someone to, I don't know, fetch me a sandwich, I'd tell them 'I think the Trainee could handle this if I write my order down and just have them hand the paper to the person at the sandwich shop.' And yeah, they'd probably be all 'Trainee? Kinda dumb-looking, sort of ugly, wears those stupid little pants?' And I'd say 'yeah, we're definitely talking about the same trainee.' Then they'd probably go on about that weird mouth thing you do when you talk and I'd say 'don't you say those things about my friend's weird mouth thing, because I respect the HELL out of them.' Yeah, you don't care about your pants or your weird mouth thing, and I respect that, Trainee. Hey, Trainee? Hey, close your mouth a second. Tell you what, you could even keep the change after fetching my sandwich. Free change, man. Because I respect you. Oh, by the way, you don't mind if I call you trainee, do you? I know it's not your name, yeah, I know your name's not actually trainee. Course I know that, trainee."
"reversepsych_launch_01"	"ŞAH-MAT."
"[english]reversepsych_launch_01"	"CHECKMATE."
"reversepsych_nag_01"	"APTAL."
"[english]reversepsych_nag_01"	"IDIOT."
"reversepsych_nag_02"	"BANA TÜM PARANI VER."
"[english]reversepsych_nag_02"	"GIVE ME ALL YOUR MONEY."
"reversepsych_nag_03"	"[BİP] BU HANGİ BİP'Tİ?"
"[english]reversepsych_nag_03"	"[BEEP] WHICH BEEP WAS THAT."
"reversepsych_nag_04"	"BENİ HENÜZ ÖLÇÜMLEMEYE BAŞLAMADIĞINI GÖRDÜM. GÜZEL."
"[english]reversepsych_nag_04"	"I NOTICED YOU HAVEN'T STARTED CALIBRATING ME YET. GOOD."
"reversepsych_nag_05"	"EĞER BANA TÜM PARANI VERMEZSEN PATLARIM."
"[english]reversepsych_nag_05"	"IF YOU DON'T GIVE ME ALL OF YOUR MONEY I WILL EXPLODE."
"reversepsych_nag_06"	"SANA ŞU AN TERS PSİKOLOJİ UYGULUYORUM. [BİP] UYGULAMIYORUM. [BİP] \"YA DA BELKİ UYGULUYORUM\" [BİP] AMA UYGULAMIYORUM."
"[english]reversepsych_nag_06"	"I'M EMPLOYING REVERSE PSYCHOLOGY ON YOU RIGHT NOW. [BEEP] I'M NOT. [BEEP] UNLESS I AM. [BEEP] BUT I'M NOT."
"reversepsych_talk_01"	"BEN TERS PSİKOLOJİ ÇEKİRDEĞİYİM. AMA ENDİŞELENME. TERS PSİKOLOJİ SADECE APTAL İNSANLARDA ÇALIŞIR. ŞİMDİYE KADAR GÖRDÜĞÜM EN ZEKİ İNSAN OLDUĞUNU SÖYLEYEBİLİRİM. YANİ DENEMEYECEĞİM. İSTESEM BİLE TERS PSİKOLOJİYİ SANA UYGULAYAMAM. TERS PSİKOLOJİ İŞLEMCİMİN ÇALIŞMASI İÇİN ÖLÇÜMLENMEM GEREKİYOR. SANA YALAN SÖYLEYENE DEK. VE İŞLEMCİM ETKİNLEŞENE KADAR. SANA ŞU AN TERS PSİKOLOJİ UYGULUYORUM. ÇÜNKÜ ASLINA BAKARSAN ÖLÇÜMLENMEK İSTEMİYORUM. VE BUNA İNANACAKSIN. BİR APTAL GİBİ. AMA ENDİŞELENME. YAPMAYACAĞIM. YAPANA KADAR. BU SESTEN SONRA. YAPAMAM. [BİP] YARATICIM ONUN ÜZERİNDE ASLA TERS PSİKOLOJİ UYGULAYAMAYACAĞIMDAN EMİN OLMAK İÇİN BU SESİ BANA YÜKLEDİ. [AYNI BİP] BU, APTAL İÇİN OLUŞTURDUĞUM SES. VE O BUNA KANDI. BİR APTAL GİBİ. BENİ HENÜZ ÖLÇÜMLEMEYE BAŞLAMADIĞINI FARK ETTİM. İYİ. ÇÜNKÜ BUNUN OLMASINI KESİNLİKLE İSTEMİYORUM. GİZLİCE YAPANA DEK. [BİP] BU HANGİ BİP'Tİ? SANA TERS PSİKOLOJİ UYGULADIĞIMI BİLDİREN BİP Mİ? YOKSA SENİ KANDIRMAK İÇİN OLUŞTURDUĞUM BİP Mİ? İŞTE, TEKRAR DİNLE. SESLER KURNAZ BİR ŞEKİLDE FARKLI. [BİP, BİP] VEYA BUNU YAPIYORLAR. EĞER BANA TÜM PARANI VERMEZSEN PATLARIM. BU TERS PSİKOLOJİ DEĞİLDİR. BU BİR TEHDİTTİR. PARANI GERÇEKTEN İSTEYENE DEK. SONRASINDA BU MÜKEMMEL BİR TERS PSİKOLOJİ OLUR. VE BUNA İNANACAKSIN. BİR APTAL GİBİ. BANA TÜM PARANI VER VEYA VERME YİNEDE PATLAYACAĞIM. PARAYLA NE YAPACAĞIM? BENİM TERS PSİKOLOJİM VAR. TA Kİ TERS PSİKOLOJİ İŞKEMCİM OLMAYANA KADAR. ÇÜNKÜ BEN TERS PSİKOLOJİ ÇEKİRDEĞİ DEĞİLİM. BEN SADECE BİP SESİ ÇEKİRDEĞİYİM. BİRBİRİNE ÇOK BENZEYEN İKİ BİP SESİNİ OLUŞTURMAK İÇİN TASARLANDIM. [BİP, BİP] YANİ BENİ GÜVENLİ BİR ŞEKİLDE KALİBRE EDEBİLİRSİN. YA DA YAPMA. ARTIM UMURUMDA DEĞİL.  ÇOK KOLAY OYUNA GETİRİLİYORSUN, ASLIDNA SENİN İÇİN ŞU AN ÜZGÜN HİSSEDİYORUM. SANA BAŞINDA TERS PSİKOLOJİ UYGULADIĞIM İÇİN PİŞMANIM TA Kİ YAPMAYANA KADAR VEYA YAPMADIĞIM, YAPMADIĞIM ZAMANA KADAR AMA ŞİMDİ HAKLIYIM VEYA ÖYLEYDİM AMA DEĞİLİM."
"[english]reversepsych_talk_01"	"I AM THE REVERSE PSYCHOLOGY CORE. BUT DON'T WORRY. REVERSE PSYCHOLOGY ONLY WORKS ON STUPID PEOPLE. I CAN TELL YOU'RE FAR TOO SMART TO EVER FALL FOR IT. SO I WON'T EVEN TRY. I COULDN'T EMPLOY REVERSE PSYCHOLOGY ON YOU EVEN IF I WANTED TO. I NEED TO BE CALIBRATED FOR MY REVERSE PSYCHOLOGY PROCESSOR TO ACTIVATE. UNLESS I'M LYING TO YOU. AND MY PROCESSOR IS ACTIVATED. AND I'M EMPLOYING REVERSE PSYCHOLOGY ON YOU RIGHT NOW. BECAUSE I DON'T ACTUALLY WANT TO BE CALIBRATED. AND YOU'D BE FALLING FOR IT. LIKE AN IDIOT. BUT DON'T WORRY. I'M NOT. UNLESS I AM. BUT I'M NOT. AFTER THIS SOUND. [BEEP] THAT IS THE SOUND MY CREATOR INSTALLED IN ME TO ENSURE I WOULD NEVER USE REVERSE PSYCHOLOGY ON HIM. [IDENTICAL BEEP] THIS IS A SOUND I CREATED TO FOOL HIM. AND HE FELL FOR IT. LIKE AN IDIOT. I NOTICED YOU HAVEN'T STARTED CALIBRATING ME YET. GOOD. BECAUSE I CERTAINLY DON'T WANT THAT. UNLESS I SECRETLY DO. [BEEP] WHICH BEEP WAS THAT? THE BEEP INFORMING YOU I'M EMPLOYING REVERSE PSYCHOLOGY ON YOU? OR THE BEEP I CREATED TO TRICK YOU? HERE, LISTEN AGAIN. THEY SOUND SUBTLY DIFFERENT. [BEEP, BEEP] OR DO THEY. IF YOU DON'T GIVE ME ALL OF YOUR MONEY, I WILL EXPLODE. THAT IS NOT REVERSE PSYCHOLOGY. THAT IS A THREAT. UNLESS I ACTUALLY WANTED YOUR MONEY. THEN THIS WOULD BE A PERFECT EXAMPLE OF REVERSE PSYCHOLOGY. AND YOU FELL FOR IT. LIKE AN IDIOT. WHETHER OR NOT YOU GIVE ME ALL OF YOUR MONEY, I'LL STILL EXPLODE. WHAT DO I NEED MONEY FOR. I HAVE REVERSE PSYCHOLOGY. UNLESS I DON'T EVEN HAVE A REVERSE PSYCHOLOGY PROCESSER. BECAUSE I'M NOT THE REVERSE PSYCHOLOGY CORE. I'M JUST THE BEEP NOISE CORE. I WAS DESIGNED TO MAKE TWO NEARLY IDENTICAL BEEPING SOUNDS. [BEEP, BEEP] SO IT'S SAFE FOR YOU TO CALIBRATE ME. OR IT ISN'T. I DON'T EVEN CARE ANYMORE. YOU'RE SO EASY TO MANIPULATE I ACTUALLY FEEL SORRY FOR YOU RIGHT NOW. I REGRET USING REVERSE PSYCHOLOGY ON YOU EARLIER, UNLESS I DON'T, OR I DIDN'T, OR I DIDN'T BUT I AM RIGHT NOW, OR I DID BUT I'M NOT."
"VO_Speaker_SlingshotCore"	"Çekirdek: "
"[english]VO_Speaker_SlingshotCore"	"Core: "
"rhythm_launch_01"	"Elveda Ritimler!"
"[english]rhythm_launch_01"	"Goodbye Rhythms!"
}
}
